PokerStars Zoom Hand #3434761638: Hold'em No Limit ($0.02/$0.05) - 2017/03/09 23:12:22
Table '#952' 6-max Seat #6 is the button
Seat 1: Small Blind ($3.53 in chips)
Seat 2: Hero ($5 in chips)
Seat 3: UTG ($5.30 in chips)
Seat 4: UTGplus1 ($5.53 in chips)
Seat 5: UTGplus2 ($6.97 in chips)
Seat 6: Dealer ($5.95 in chips)
Small Blind: posts small blind $0.02
Hero: posts big blind $0.05
*** HOLE CARDS ***
Dealt to Hero [Ah 5s]
UTG: folds
UTGplus1: raises $0.15 to $0.15
UTGplus2: folds
Dealer: folds
Small Blind: folds
Hero: calls $0.10 
*** FLOP *** [7s Kc 6d]
Hero: checks
UTGplus1: bets $0.15 
Hero: folds
Uncalled bet ($0.15) returned to UTGplus1
UTGplus1: doesn't show hand
UTGplus1 collected $0.31 from pot
Table deposit $0.57 
*** SUMMARY ***
Total pot $0.32 | Rake $0.01
Board [7s Kc 6d]
Seat 1: Small Blind (small blind) showed
Seat 2: Hero (big blind) showed
Seat 3: UTG showed
Seat 4: UTGplus1 won ($0.31)
Seat 5: UTGplus2 showed
Seat 6: Dealer (button) showed



PokerStars Zoom Hand #3434761815: Hold'em No Limit ($0.02/$0.05) - 2017/03/09 23:12:44
Table '#952' 6-max Seat #2 is the button
Seat 1: Hero ($4.85 in chips)
Seat 2: Dealer ($6.51 in chips)
Seat 3: Small Blind ($3.47 in chips)
Seat 4: Big Blind ($3.51 in chips)
Seat 5: UTG ($6.18 in chips)
Seat 6: UTGplus1 ($7.51 in chips)
Small Blind: posts small blind $0.02
Big Blind: posts big blind $0.05
*** HOLE CARDS ***
Dealt to Hero [As 2s]
UTG: folds
UTGplus1: folds
Hero: raises $0.17 to $0.17
Dealer: folds
Small Blind: folds
Big Blind: calls $0.12 
*** FLOP *** [2c Kc 3d]
Big Blind: checks
Hero: bets $0.23 
Big Blind: folds
Uncalled bet ($0.23) returned to Hero
Hero: doesn't show hand
Hero collected $0.35 from pot
*** SUMMARY ***
Total pot $0.36 | Rake $0.01
Board [2c Kc 3d]
Seat 1: Hero won ($0.35)
Seat 2: Dealer (button) showed
Seat 3: Small Blind (small blind) showed
Seat 4: Big Blind (big blind) showed
Seat 5: UTG showed
Seat 6: UTGplus1 showed



PokerStars Zoom Hand #3434762113: Hold'em No Limit ($0.02/$0.05) - 2017/03/09 23:13:24
Table '#952' 6-max Seat #6 is the button
Seat 1: Small Blind ($4.68 in chips)
Seat 2: Big Blind ($5.54 in chips)
Seat 3: UTG ($1.31 in chips)
Seat 4: Hero ($5.03 in chips)
Seat 5: UTGplus2 ($6.59 in chips)
Seat 6: Dealer ($3.41 in chips)
Small Blind: posts small blind $0.02
Big Blind: posts big blind $0.05
*** HOLE CARDS ***
Dealt to Hero [6d 3s]
UTG: raises $0.20 to $0.20
Hero: folds
UTGplus2: raises $0.67 to $0.67
Dealer: folds
Small Blind: folds
Big Blind: folds
UTG: raises $1.04 to $1.24
UTGplus2: raises $1.14 to $1.81
UTG: calls $0.07 and is all-in
*** FLOP *** [Ah 4d Td]
*** TURN *** [Ah 4d Td] [7h]
*** RIVER *** [Ah 4d Td 7h] [8d]
*** SHOW DOWN ***
UTG: shows [Ad Kd] (a flush, Ace high)
UTGplus2: shows [Ts Tc] (three of a kind, Tens)
Uncalled bet ($0.50) returned to UTGplus2
UTG collected $2.56 from pot
*** SUMMARY ***
Total pot $2.69 | Rake $0.13
Board [Ah 4d Td 7h 8d]
Seat 1: Small Blind (small blind) showed
Seat 2: Big Blind (big blind) showed
Seat 3: UTG showed [Ad Kd] and won ($2.56) with a flush, Ten high
Seat 4: Hero showed
Seat 5: UTGplus2 showed [Ts Tc] and lost with three of a kind, Tens
Seat 6: Dealer (button) showed



PokerStars Zoom Hand #3434762159: Hold'em No Limit ($0.02/$0.05) - 2017/03/09 23:13:30
Table '#952' 6-max Seat #1 is the button
Seat 1: Hero ($5.03 in chips)
Seat 2: Small Blind ($6.30 in chips)
Seat 3: Big Blind ($1.91 in chips)
Seat 4: UTG ($2.69 in chips)
Seat 5: UTGplus1 ($3.09 in chips)
Seat 6: UTGplus2 ($6.56 in chips)
Small Blind: posts small blind $0.02
Big Blind: posts big blind $0.05
*** HOLE CARDS ***
Dealt to Hero [Ac Ts]
UTG: folds
UTGplus1: folds
UTGplus2: raises $0.12 to $0.12
Hero: calls $0.12 
Small Blind: folds
Big Blind: folds
*** FLOP *** [Qc 4c Ks]
UTGplus2: bets $0.15 
Hero: calls $0.15 
*** TURN *** [Qc 4c Ks] [3h]
UTGplus2: bets $0.42 
Hero: folds
Uncalled bet ($0.42) returned to UTGplus2
UTGplus2: doesn't show hand
UTGplus2 collected $0.58 from pot
Table deposit $0.09 
*** SUMMARY ***
Total pot $0.61 | Rake $0.03
Board [Qc 4c Ks 3h]
Seat 1: Hero (button) showed
Seat 2: Small Blind (small blind) showed
Seat 3: Big Blind (big blind) showed
Seat 4: UTG showed
Seat 5: UTGplus1 showed
Seat 6: UTGplus2 won ($0.58)



PokerStars Zoom Hand #3434762440: Hold'em No Limit ($0.02/$0.05) - 2017/03/09 23:14:05
Table '#952' 6-max Seat #2 is the button
Seat 1: UTGplus2 ($6.58 in chips)
Seat 2: Dealer ($10.03 in chips)
Seat 3: Small Blind ($3.14 in chips)
Seat 4: Big Blind ($5.49 in chips)
Seat 5: Hero ($4.76 in chips)
Seat 6: UTGplus1 ($2.83 in chips)
Small Blind: posts small blind $0.02
Big Blind: posts big blind $0.05
*** HOLE CARDS ***
Dealt to Hero [Tc 4s]
Hero: folds
UTGplus1: folds
UTGplus2: folds
Dealer: raises $0.10 to $0.10
Small Blind: raises $0.13 to $0.15
Big Blind: folds
Dealer: calls $0.05 
*** FLOP *** [Qs 9s Ts]
Small Blind: bets $0.17 
Dealer: folds
Uncalled bet ($0.17) returned to Small Blind
Small Blind: doesn't show hand
Small Blind collected $0.34 from pot
*** SUMMARY ***
Total pot $0.35 | Rake $0.01
Board [Qs 9s Ts]
Seat 1: UTGplus2 showed
Seat 2: Dealer (button) showed
Seat 3: Small Blind (small blind) won ($0.34)
Seat 4: Big Blind (big blind) showed
Seat 5: Hero showed
Seat 6: UTGplus1 showed



PokerStars Zoom Hand #3434762475: Hold'em No Limit ($0.02/$0.05) - 2017/03/09 23:14:10
Table '#952' 6-max Seat #5 is the button
Seat 1: Big Blind ($6.61 in chips)
Seat 2: UTG ($4.40 in chips)
Seat 3: Hero ($4.76 in chips)
Seat 4: UTGplus2 ($11.29 in chips)
Seat 5: Dealer ($5 in chips)
Seat 6: Small Blind ($10.70 in chips)
Small Blind: posts small blind $0.02
Big Blind: posts big blind $0.05
*** HOLE CARDS ***
Dealt to Hero [7h 8s]
UTG: calls $0.05 
Hero: calls $0.05 
UTGplus2: folds
Dealer: folds
Small Blind: folds
Big Blind: checks
*** FLOP *** [Qd 4c 7c]
Big Blind: checks
UTG: checks
Hero: checks
*** TURN *** [Qd 4c 7c] [8c]
Big Blind: checks
UTG: checks
Hero: bets $0.13 
Big Blind: folds
UTG: folds
Uncalled bet ($0.13) returned to Hero
Hero: doesn't show hand
Hero collected $0.17 from pot
*** SUMMARY ***
Total pot $0.17 | Rake $0.00
Board [Qd 4c 7c 8c]
Seat 1: Big Blind (big blind) showed
Seat 2: UTG showed
Seat 3: Hero won ($0.17)
Seat 4: UTGplus2 showed
Seat 5: Dealer (button) showed
Seat 6: Small Blind (small blind) showed



PokerStars Zoom Hand #3434762771: Hold'em No Limit ($0.02/$0.05) - 2017/03/09 23:14:52
Table '#952' 6-max Seat #5 is the button
Seat 1: Big Blind ($7.03 in chips)
Seat 2: Hero ($4.88 in chips)
Seat 3: UTGplus1 ($2.46 in chips)
Seat 4: UTGplus2 ($18.80 in chips)
Seat 5: Dealer ($6.36 in chips)
Seat 6: Small Blind ($11.20 in chips)
Small Blind: posts small blind $0.02
Big Blind: posts big blind $0.05
*** HOLE CARDS ***
Dealt to Hero [6h Jd]
Hero: folds
UTGplus1: calls $0.05 
UTGplus2: folds
Dealer: folds
Small Blind: raises $0.18 to $0.20
Big Blind: folds
UTGplus1: calls $0.15 
*** FLOP *** [3d 7s 3h]
Small Blind: bets $0.20 
UTGplus1: raises $0.40 to $0.40
Small Blind: calls $0.20 
*** TURN *** [3d 7s 3h] [4s]
Small Blind: checks
UTGplus1: checks
*** RIVER *** [3d 7s 3h 4s] [8h]
Small Blind: bets $10.60 and is all-in
UTGplus1: folds
Uncalled bet ($10.60) returned to Small Blind
Small Blind: doesn't show hand
Small Blind collected $1.19 from pot
Table deposit $5 
*** SUMMARY ***
Total pot $1.25 | Rake $0.06
Board [3d 7s 3h 4s 8h]
Seat 1: Big Blind (big blind) showed
Seat 2: Hero showed
Seat 3: UTGplus1 showed
Seat 4: UTGplus2 showed
Seat 5: Dealer (button) showed
Seat 6: Small Blind (small blind) won ($1.19)



PokerStars Zoom Hand #3434762815: Hold'em No Limit ($0.02/$0.05) - 2017/03/09 23:14:58
Table '#952' 6-max Seat #5 is the button
Seat 1: Hero ($4.88 in chips)
Seat 2: UTG ($5 in chips)
Seat 3: UTGplus1 ($4.93 in chips)
Seat 4: UTGplus2 ($9.11 in chips)
Seat 5: Dealer ($5.20 in chips)
Seat 6: Small Blind ($3.75 in chips)
Small Blind: posts small blind $0.02
Hero: posts big blind $0.05
*** HOLE CARDS ***
Dealt to Hero [5d 8c]
UTG: folds
UTGplus1: folds
UTGplus2: folds
Dealer: folds
Small Blind: folds
*** SHOW DOWN ***
Hero: shows [5d 8c] (high card Five)
Hero collected $0.07 from pot
*** SUMMARY ***
Total pot $0.07 | Rake $0.00
Seat 1: Hero (big blind) collected $0.02
Seat 2: UTG showed
Seat 3: UTGplus1 showed
Seat 4: UTGplus2 showed
Seat 5: Dealer (button) showed
Seat 6: Small Blind (small blind) showed



PokerStars Zoom Hand #3434762866: Hold'em No Limit ($0.02/$0.05) - 2017/03/09 23:15:05
Table '#952' 6-max Seat #5 is the button
Seat 1: Big Blind ($7.51 in chips)
Seat 2: UTG ($3.36 in chips)
Seat 3: UTGplus1 ($10.66 in chips)
Seat 4: Hero ($4.83 in chips)
Seat 5: Dealer ($2.11 in chips)
Seat 6: Small Blind ($5.72 in chips)
Small Blind: posts small blind $0.02
Big Blind: posts big blind $0.05
*** HOLE CARDS ***
Dealt to Hero [5d 9c]
UTG: folds
UTGplus1: folds
Hero: folds
Dealer: folds
Small Blind: folds
Big Blind: doesn't show hand
Big Blind collected $0.07 from pot
UTG: Table leave user
*** SUMMARY ***
Total pot $0.07 | Rake $0.00
Seat 1: Big Blind (big blind) won ($0.07)
Seat 2: UTG showed
Seat 3: UTGplus1 showed
Seat 4: Hero showed
Seat 5: Dealer (button) showed
Seat 6: Small Blind (small blind) showed



PokerStars Zoom Hand #3434762883: Hold'em No Limit ($0.02/$0.05) - 2017/03/09 23:15:09
Table '#952' 6-max Seat #6 is the button
Seat 1: Small Blind ($5.21 in chips)
Seat 2: Big Blind ($2.11 in chips)
Seat 3: UTG ($18.80 in chips)
Seat 4: UTGplus1 ($5.70 in chips)
Seat 5: Hero ($4.83 in chips)
Seat 6: Dealer ($7.07 in chips)
Small Blind: posts small blind $0.02
Big Blind: posts big blind $0.05
*** HOLE CARDS ***
Dealt to Hero [Ah Ac]
UTG: raises $0.12 to $0.12
UTGplus1: folds
Hero: raises $0.38 to $0.38
Dealer: folds
Small Blind: folds
Big Blind: folds
UTG: calls $0.26 
*** FLOP *** [4c 7s 9s]
UTG: checks
Hero: bets $0.41 
UTG: calls $0.41 
*** TURN *** [4c 7s 9s] [As]
UTG: checks
Hero: checks
*** RIVER *** [4c 7s 9s As] [Qs]
UTG: bets $0.82 
Hero: calls $0.82 
*** SHOW DOWN ***
UTG: shows [8s 8d] (a flush, Ace high)
Hero: shows [Ah Ac] (Three of a kind)
UTG collected $3.13 from pot
*** SUMMARY ***
Total pot $3.29 | Rake $0.16
Board [4c 7s 9s As Qs]
Seat 1: Small Blind (small blind) showed
Seat 2: Big Blind (big blind) showed
Seat 3: UTG showed [8s 8d] and won ($3.13) with a flush, Ace high
Seat 4: UTGplus1 showed
Seat 5: Hero showed [Ah Ac]
Seat 6: Dealer (button) showed



PokerStars Zoom Hand #3434763386: Hold'em No Limit ($0.02/$0.05) - 2017/03/09 23:16:19
Table '#952' 6-max Seat #5 is the button
Seat 1: Big Blind ($6.04 in chips)
Seat 2: UTG ($12.39 in chips)
Seat 3: UTGplus1 ($2.21 in chips)
Seat 4: UTGplus2 ($16.93 in chips)
Seat 5: Dealer ($20.32 in chips)
Seat 6: Hero ($3.29 in chips)
Hero: posts small blind $0.02
Big Blind: posts big blind $0.05
*** HOLE CARDS ***
Dealt to Hero [9d 4s]
UTG: folds
UTGplus1: folds
UTGplus2: raises $0.10 to $0.10
Dealer: calls $0.10 
Hero: folds
Big Blind: folds
*** FLOP *** [5s 6s Ac]
UTGplus2: checks
Dealer: bets $0.13 
UTGplus2: folds
Uncalled bet ($0.13) returned to Dealer
Dealer: doesn't show hand
Dealer collected $0.26 from pot
*** SUMMARY ***
Total pot $0.27 | Rake $0.01
Board [5s 6s Ac]
Seat 1: Big Blind (big blind) showed
Seat 2: UTG showed
Seat 3: UTGplus1 showed
Seat 4: UTGplus2 showed
Seat 5: Dealer (button) won ($0.26)
Seat 6: Hero (small blind) showed



PokerStars Zoom Hand #3434763476: Hold'em No Limit ($0.02/$0.05) - 2017/03/09 23:16:30
Table '#952' 6-max Seat #1 is the button
Seat 1: Hero ($3.27 in chips)
Seat 2: Small Blind ($3.49 in chips)
Seat 3: Big Blind ($3.69 in chips)
Seat 4: UTG ($2.80 in chips)
Seat 5: UTGplus1 ($3.11 in chips)
Seat 6: UTGplus2 ($7.27 in chips)
Small Blind: posts small blind $0.02
Big Blind: posts big blind $0.05
*** HOLE CARDS ***
Dealt to Hero [5c Js]
UTG: folds
UTGplus1: folds
UTGplus2: raises $0.15 to $0.15
Hero: folds
Small Blind: calls $0.13 
Big Blind: folds
*** FLOP *** [9c 9h 7s]
Small Blind: checks
UTGplus2: bets $0.17 
Small Blind: folds
Uncalled bet ($0.17) returned to UTGplus2
UTGplus2: doesn't show hand
UTGplus2 collected $0.34 from pot
*** SUMMARY ***
Total pot $0.35 | Rake $0.01
Board [9c 9h 7s]
Seat 1: Hero (button) showed
Seat 2: Small Blind (small blind) showed
Seat 3: Big Blind (big blind) showed
Seat 4: UTG showed
Seat 5: UTGplus1 showed
Seat 6: UTGplus2 won ($0.34)



PokerStars Zoom Hand #3434763504: Hold'em No Limit ($0.02/$0.05) - 2017/03/09 23:16:34
Table '#952' 6-max Seat #5 is the button
Seat 1: Big Blind ($6.72 in chips)
Seat 2: UTG ($6.86 in chips)
Seat 3: UTGplus1 ($4.95 in chips)
Seat 4: Hero ($3.27 in chips)
Seat 5: Dealer ($4.43 in chips)
Seat 6: Small Blind ($9.98 in chips)
Small Blind: posts small blind $0.02
Big Blind: posts big blind $0.05
*** HOLE CARDS ***
Dealt to Hero [9d Qs]
UTG: raises $0.15 to $0.15
UTGplus1: folds
Hero: folds
Dealer: folds
Small Blind: folds
Big Blind: raises $0.20 to $0.25
UTG: calls $0.10 
*** FLOP *** [4d 6c Jd]
Big Blind: bets $0.05 
UTG: raises $0.43 to $0.43
Big Blind: folds
Uncalled bet ($0.38) returned to UTG
UTG: doesn't show hand
UTG collected $0.59 from pot
*** SUMMARY ***
Total pot $0.62 | Rake $0.03
Board [4d 6c Jd]
Seat 1: Big Blind (big blind) showed
Seat 2: UTG won ($0.59)
Seat 3: UTGplus1 showed
Seat 4: Hero showed
Seat 5: Dealer (button) showed
Seat 6: Small Blind (small blind) showed



PokerStars Zoom Hand #3434763591: Hold'em No Limit ($0.02/$0.05) - 2017/03/09 23:16:45
Table '#952' 6-max Seat #5 is the button
Seat 1: Big Blind ($2.80 in chips)
Seat 2: UTG ($4.95 in chips)
Seat 3: Hero ($3.27 in chips)
Seat 4: UTGplus2 ($5.21 in chips)
Seat 5: Dealer ($1.88 in chips)
Seat 6: Small Blind ($16.13 in chips)
Small Blind: posts small blind $0.02
Big Blind: posts big blind $0.05
*** HOLE CARDS ***
Dealt to Hero [Qh 9d]
UTG: folds
Hero: folds
UTGplus2: folds
Dealer: folds
Small Blind: raises $0.13 to $0.15
Big Blind: calls $0.10 
*** FLOP *** [Th 3c 5s]
Small Blind: bets $0.15 
Big Blind: calls $0.15 
*** TURN *** [Th 3c 5s] [Jc]
Small Blind: bets $0.35 
Big Blind: calls $0.35 
*** RIVER *** [Th 3c 5s Jc] [6s]
Small Blind: checks
Big Blind: checks
*** SHOW DOWN ***
Small Blind: shows [Jh Kh] (a pair of Jacks)
Big Blind: shows [4d 6c] (One pair)
Small Blind collected $1.24 from pot
*** SUMMARY ***
Total pot $1.3 | Rake $0.06
Board [Th 3c 5s Jc 6s]
Seat 1: Big Blind (big blind) showed [4d 6c]
Seat 2: UTG showed
Seat 3: Hero showed
Seat 4: UTGplus2 showed
Seat 5: Dealer (button) showed
Seat 6: Small Blind (small blind) showed [Jh Kh] and won ($1.24) with a pair of Jacks



PokerStars Zoom Hand #3434763658: Hold'em No Limit ($0.02/$0.05) - 2017/03/09 23:16:53
Table '#952' 6-max Seat #2 is the button
Seat 1: UTGplus2 ($1.98 in chips)
Seat 2: Dealer ($5.99 in chips)
Seat 3: Small Blind ($16.83 in chips)
Seat 4: Hero ($3.27 in chips)
Seat 5: UTG ($9.54 in chips)
Seat 6: UTGplus1 ($10.45 in chips)
Small Blind: posts small blind $0.02
Hero: posts big blind $0.05
*** HOLE CARDS ***
Dealt to Hero [3d 7c]
UTG: folds
UTGplus1: folds
UTGplus2: raises $0.15 to $0.15
Dealer: folds
Small Blind: folds
Hero: folds
Uncalled bet ($0.10) returned to UTGplus2
UTGplus2: doesn't show hand
UTGplus2 collected $0.12 from pot
Table deposit $5 
*** SUMMARY ***
Total pot $0.12 | Rake $0.00
Seat 1: UTGplus2 won ($0.12)
Seat 2: Dealer (button) showed
Seat 3: Small Blind (small blind) showed
Seat 4: Hero (big blind) showed
Seat 5: UTG showed
Seat 6: UTGplus1 showed



PokerStars Zoom Hand #3434763699: Hold'em No Limit ($0.02/$0.05) - 2017/03/09 23:16:59
Table '#952' 6-max Seat #3 is the button
Seat 1: UTGplus1 ($5.21 in chips)
Seat 2: Hero ($3.22 in chips)
Seat 3: Dealer ($4.95 in chips)
Seat 4: Small Blind ($8.74 in chips)
Seat 5: Big Blind ($16.81 in chips)
Seat 6: UTG ($9.97 in chips)
Small Blind: posts small blind $0.02
Big Blind: posts big blind $0.05
*** HOLE CARDS ***
Dealt to Hero [8d Js]
UTG: folds
UTGplus1: folds
Hero: folds
Dealer: raises $0.15 to $0.15
Small Blind: folds
Big Blind: calls $0.10 
*** FLOP *** [Ac 7c 9h]
Big Blind: checks
Dealer: bets $0.20 
Big Blind: raises $0.40 to $0.40
Dealer: calls $0.20 
*** TURN *** [Ac 7c 9h] [9d]
Big Blind: checks
Dealer: checks
*** RIVER *** [Ac 7c 9h 9d] [5s]
Big Blind: checks
Dealer: checks
*** SHOW DOWN ***
Big Blind: shows [4d 4h] (two pair, Nines and Aces)
Dealer: shows [Jc 8c] (One pair)
Big Blind collected $1.07 from pot
*** SUMMARY ***
Total pot $1.12 | Rake $0.05
Board [Ac 7c 9h 9d 5s]
Seat 1: UTGplus1 showed
Seat 2: Hero showed
Seat 3: Dealer (button) showed [Jc 8c]
Seat 4: Small Blind (small blind) showed
Seat 5: Big Blind (big blind) showed [4d 4h] and won ($1.07) with two pair, Nines and Aces
Seat 6: UTG showed



PokerStars Zoom Hand #3434763741: Hold'em No Limit ($0.02/$0.05) - 2017/03/09 23:17:04
Table '#952' 6-max Seat #5 is the button
Seat 1: Big Blind ($4.86 in chips)
Seat 2: UTG ($6.05 in chips)
Seat 3: UTGplus1 ($3.14 in chips)
Seat 4: UTGplus2 ($1.77 in chips)
Seat 5: Dealer ($3.92 in chips)
Seat 6: Hero ($3.22 in chips)
Hero: posts small blind $0.02
Big Blind: posts big blind $0.05
*** HOLE CARDS ***
Dealt to Hero [7h 9d]
UTG: folds
UTGplus1: folds
UTGplus2: folds
Dealer: folds
Hero: folds
*** SHOW DOWN ***
Big Blind: shows [2d Js] (high card Deuce)
Big Blind collected $0.07 from pot
*** SUMMARY ***
Total pot $0.07 | Rake $0.00
Seat 1: Big Blind (big blind) collected $0.02
Seat 2: UTG showed
Seat 3: UTGplus1 showed
Seat 4: UTGplus2 showed
Seat 5: Dealer (button) showed
Seat 6: Hero (small blind) showed



PokerStars Zoom Hand #3434763807: Hold'em No Limit ($0.02/$0.05) - 2017/03/09 23:17:12
Table '#952' 6-max Seat #6 is the button
Seat 1: Small Blind ($6.09 in chips)
Seat 2: Big Blind ($1.23 in chips)
Seat 3: UTG ($7.15 in chips)
Seat 4: UTGplus1 ($5.57 in chips)
Seat 5: Hero ($3.20 in chips)
Seat 6: Dealer ($11.02 in chips)
Small Blind: posts small blind $0.02
Big Blind: posts big blind $0.05
*** HOLE CARDS ***
Dealt to Hero [9d 2s]
UTG: raises $0.15 to $0.15
UTGplus1: calls $0.15 
Hero: folds
Dealer: folds
Small Blind: raises $0.73 to $0.75
Big Blind: folds
UTG: folds
UTGplus1: folds
Uncalled bet ($0.60) returned to Small Blind
Small Blind: doesn't show hand
Small Blind collected $0.5 from pot
*** SUMMARY ***
Total pot $0.5 | Rake $0.00
Seat 1: Small Blind (small blind) won ($0.5)
Seat 2: Big Blind (big blind) showed
Seat 3: UTG showed
Seat 4: UTGplus1 showed
Seat 5: Hero showed
Seat 6: Dealer (button) showed



PokerStars Zoom Hand #3434763847: Hold'em No Limit ($0.02/$0.05) - 2017/03/09 23:17:18
Table '#952' 6-max Seat #2 is the button
Seat 1: UTGplus2 ($11.02 in chips)
Seat 2: Hero ($3.20 in chips)
Seat 3: Small Blind ($5 in chips)
Seat 4: Big Blind ($1.77 in chips)
Seat 5: UTG ($5.14 in chips)
Seat 6: UTGplus1 ($17.32 in chips)
Small Blind: posts small blind $0.02
Big Blind: posts big blind $0.05
*** HOLE CARDS ***
Dealt to Hero [2h As]
UTG: folds
UTGplus1: folds
UTGplus2: folds
Hero: raises $0.17 to $0.17
Small Blind: folds
Big Blind: folds
Uncalled bet ($0.12) returned to Hero
Hero: doesn't show hand
Hero collected $0.12 from pot
Table deposit $2.50 
*** SUMMARY ***
Total pot $0.12 | Rake $0.00
Seat 1: UTGplus2 showed
Seat 2: Hero (button) won ($0.12)
Seat 3: Small Blind (small blind) showed
Seat 4: Big Blind (big blind) showed
Seat 5: UTG showed
Seat 6: UTGplus1 showed



PokerStars Zoom Hand #3434764104: Hold'em No Limit ($0.02/$0.05) - 2017/03/09 23:17:51
Table '#952' 6-max Seat #1 is the button
Seat 1: Dealer ($5.85 in chips)
Seat 2: Small Blind ($6.17 in chips)
Seat 3: Hero ($3.27 in chips)
Seat 4: UTG ($9.95 in chips)
Seat 5: UTGplus1 ($4.44 in chips)
Seat 6: UTGplus2 ($4.81 in chips)
Small Blind: posts small blind $0.02
Hero: posts big blind $0.05
*** HOLE CARDS ***
Dealt to Hero [9s As]
UTG: folds
UTGplus1: folds
UTGplus2: folds
Dealer: folds
Small Blind: folds
Hero: doesn't show hand
Hero collected $0.07 from pot
*** SUMMARY ***
Total pot $0.07 | Rake $0.00
Seat 1: Dealer (button) showed
Seat 2: Small Blind (small blind) showed
Seat 3: Hero (big blind) won ($0.07)
Seat 4: UTG showed
Seat 5: UTGplus1 showed
Seat 6: UTGplus2 showed



PokerStars Zoom Hand #3434764217: Hold'em No Limit ($0.02/$0.05) - 2017/03/09 23:18:05
Table '#952' 6-max Seat #5 is the button
Seat 1: Big Blind ($2.07 in chips)
Seat 2: UTG ($3.73 in chips)
Seat 3: Hero ($3.29 in chips)
Seat 4: UTGplus2 ($4.88 in chips)
Seat 5: Dealer ($1.32 in chips)
Seat 6: Small Blind ($3.03 in chips)
Small Blind: posts small blind $0.02
Big Blind: posts big blind $0.05
*** HOLE CARDS ***
Dealt to Hero [4d Ad]
UTG: folds
Hero: raises $0.17 to $0.17
UTGplus2: folds
Dealer: folds
Small Blind: folds
Big Blind: folds
Uncalled bet ($0.12) returned to Hero
Hero: doesn't show hand
Hero collected $0.12 from pot
*** SUMMARY ***
Total pot $0.12 | Rake $0.00
Seat 1: Big Blind (big blind) showed
Seat 2: UTG showed
Seat 3: Hero won ($0.12)
Seat 4: UTGplus2 showed
Seat 5: Dealer (button) showed
Seat 6: Small Blind (small blind) showed



PokerStars Zoom Hand #3434764384: Hold'em No Limit ($0.02/$0.05) - 2017/03/09 23:18:28
Table '#952' 6-max Seat #5 is the button
Seat 1: Big Blind ($6.49 in chips)
Seat 2: Hero ($3.36 in chips)
Seat 3: UTGplus1 ($2.22 in chips)
Seat 4: UTGplus2 ($1.58 in chips)
Seat 5: Dealer ($5.60 in chips)
Seat 6: Small Blind ($8.66 in chips)
Small Blind: posts small blind $0.02
Big Blind: posts big blind $0.05
*** HOLE CARDS ***
Dealt to Hero [7d Qs]
Hero: folds
UTGplus1: folds (auth)
UTGplus1: Table leave user
UTGplus2: raises $0.15 to $0.15
Dealer: calls $0.15 
Small Blind: calls $0.13 
Big Blind: calls $0.10 
*** FLOP *** [6c Qh Ts]
Small Blind: checks
Big Blind: checks
UTGplus2: bets $0.10 
Dealer: folds
Small Blind: folds
Big Blind: calls $0.10 
*** TURN *** [6c Qh Ts] [Kh]
Big Blind: checks
UTGplus2: checks
*** RIVER *** [6c Qh Ts Kh] [Qc]
Big Blind: checks
UTGplus2: bets $0.25 
Big Blind: folds
Uncalled bet ($0.25) returned to UTGplus2
UTGplus2: doesn't show hand
UTGplus2 collected $0.76 from pot
*** SUMMARY ***
Total pot $0.8 | Rake $0.04
Board [6c Qh Ts Kh Qc]
Seat 1: Big Blind (big blind) showed
Seat 2: Hero showed
Seat 3: UTGplus1 showed
Seat 4: UTGplus2 won ($0.76)
Seat 5: Dealer (button) showed
Seat 6: Small Blind (small blind) showed



PokerStars Zoom Hand #3434764486: Hold'em No Limit ($0.02/$0.05) - 2017/03/09 23:18:41
Table '#952' 6-max Seat #5 is the button
Seat 1: Big Blind ($4.49 in chips)
Seat 2: UTG ($6.44 in chips)
Seat 3: UTGplus1 ($7.20 in chips)
Seat 4: Hero ($5 in chips)
Seat 5: Dealer ($1.19 in chips)
Seat 6: Small Blind ($3.90 in chips)
Small Blind: posts small blind $0.02
Big Blind: posts big blind $0.05
*** HOLE CARDS ***
Dealt to Hero [Qs Kh]
UTG: raises $0.15 to $0.15
UTGplus1: folds
Hero: calls $0.15 
Dealer: folds
Small Blind: folds
Big Blind: folds
*** FLOP *** [3d 8h 4s]
UTG: checks
Hero: bets $0.18 
UTG: calls $0.18 
*** TURN *** [3d 8h 4s] [7c]
UTG: checks
Hero: checks
*** RIVER *** [3d 8h 4s 7c] [Ac]
UTG: checks
Hero: checks
*** SHOW DOWN ***
UTG: shows [8s 9s] (a pair of Eights)
Hero: shows [Qs Kh] (High Card)
UTG collected $0.7 from pot
*** SUMMARY ***
Total pot $0.73 | Rake $0.03
Board [3d 8h 4s 7c Ac]
Seat 1: Big Blind (big blind) showed
Seat 2: UTG showed [8s 9s] and won ($0.7) with a pair of Eights
Seat 3: UTGplus1 showed
Seat 4: Hero showed [Qs Kh]
Seat 5: Dealer (button) showed
Seat 6: Small Blind (small blind) showed



PokerStars Zoom Hand #3434764973: Hold'em No Limit ($0.02/$0.05) - 2017/03/09 23:19:43
Table '#952' 6-max Seat #5 is the button
Seat 1: Hero ($4.67 in chips)
Seat 2: UTG ($2.43 in chips)
Seat 3: UTGplus1 ($4.95 in chips)
Seat 4: UTGplus2 ($6.40 in chips)
Seat 5: Dealer ($5.09 in chips)
Seat 6: Small Blind ($6 in chips)
Small Blind: posts small blind $0.02
Hero: posts big blind $0.05
*** HOLE CARDS ***
Dealt to Hero [Kh 7d]
UTG: calls $0.05 
UTGplus1: raises $0.22 to $0.22
UTGplus2: folds
Dealer: folds
Small Blind: folds
Hero: folds
UTG: calls $0.17 
*** FLOP *** [4d 9h 9s]
UTG: checks
UTGplus1: bets $0.21 
UTG: folds
Uncalled bet ($0.21) returned to UTGplus1
UTGplus1: doesn't show hand
UTGplus1 collected $0.49 from pot
*** SUMMARY ***
Total pot $0.51 | Rake $0.02
Board [4d 9h 9s]
Seat 1: Hero (big blind) showed
Seat 2: UTG showed
Seat 3: UTGplus1 won ($0.49)
Seat 4: UTGplus2 showed
Seat 5: Dealer (button) showed
Seat 6: Small Blind (small blind) showed



PokerStars Zoom Hand #3434765163: Hold'em No Limit ($0.02/$0.05) - 2017/03/09 23:20:07
Table '#952' 6-max Seat #4 is the button
Seat 1: UTG ($5.05 in chips)
Seat 2: UTGplus1 ($2.15 in chips)
Seat 3: Hero ($4.62 in chips)
Seat 4: Dealer ($1.66 in chips)
Seat 5: Small Blind ($5.98 in chips)
Seat 6: Big Blind ($4.70 in chips)
Small Blind: posts small blind $0.02
Big Blind: posts big blind $0.05
*** HOLE CARDS ***
Dealt to Hero [8h Kc]
UTG: folds
UTGplus1: folds
Hero: folds
Dealer: folds
Small Blind: folds
Big Blind: doesn't show hand
Big Blind collected $0.07 from pot
Table deposit $5 
*** SUMMARY ***
Total pot $0.07 | Rake $0.00
Seat 1: UTG showed
Seat 2: UTGplus1 showed
Seat 3: Hero showed
Seat 4: Dealer (button) showed
Seat 5: Small Blind (small blind) showed
Seat 6: Big Blind (big blind) won ($0.07)



PokerStars Zoom Hand #3434765215: Hold'em No Limit ($0.02/$0.05) - 2017/03/09 23:20:13
Table '#952' 6-max Seat #2 is the button
Seat 1: UTGplus2 ($5.31 in chips)
Seat 2: Hero ($4.62 in chips)
Seat 3: Small Blind ($5.76 in chips)
Seat 4: Big Blind ($5.09 in chips)
Seat 5: UTG ($4.23 in chips)
Seat 6: UTGplus1 ($1.43 in chips)
Small Blind: posts small blind $0.02
Big Blind: posts big blind $0.05
*** HOLE CARDS ***
Dealt to Hero [5s 3h]
UTG: folds
UTGplus1: raises $0.17 to $0.17
UTGplus2: folds
Hero: folds
Small Blind: folds
Big Blind: folds
Uncalled bet ($0.12) returned to UTGplus1
UTGplus1: doesn't show hand
UTGplus1 collected $0.12 from pot
UTGplus2: Seat re-join
*** SUMMARY ***
Total pot $0.12 | Rake $0.00
Seat 1: UTGplus2 showed
Seat 2: Hero (button) showed
Seat 3: Small Blind (small blind) showed
Seat 4: Big Blind (big blind) showed
Seat 5: UTG showed
Seat 6: UTGplus1 won ($0.12)



PokerStars Zoom Hand #3434765250: Hold'em No Limit ($0.02/$0.05) - 2017/03/09 23:20:17
Table '#952' 6-max Seat #5 is the button
Seat 1: Big Blind ($2.98 in chips)
Seat 2: UTG ($5.31 in chips)
Seat 3: UTGplus1 ($7.65 in chips)
Seat 4: UTGplus2 ($9.98 in chips)
Seat 5: Dealer ($2.51 in chips)
Seat 6: Hero ($4.62 in chips)
Hero: posts small blind $0.02
Big Blind: posts big blind $0.05
*** HOLE CARDS ***
Dealt to Hero [Ac Td]
UTG: folds
UTGplus1: raises $0.15 to $0.15
UTGplus2: calls $0.15 
Dealer: folds
Hero: calls $0.13 
Big Blind: folds
*** FLOP *** [Qc 5s 2c]
Hero: checks
UTGplus1: checks
UTGplus2: bets $0.43 
Hero: folds
UTGplus1: folds
Uncalled bet ($0.43) returned to UTGplus2
UTGplus2: doesn't show hand
UTGplus2 collected $0.48 from pot
*** SUMMARY ***
Total pot $0.5 | Rake $0.02
Board [Qc 5s 2c]
Seat 1: Big Blind (big blind) showed
Seat 2: UTG showed
Seat 3: UTGplus1 showed
Seat 4: UTGplus2 won ($0.48)
Seat 5: Dealer (button) showed
Seat 6: Hero (small blind) showed



PokerStars Zoom Hand #3434765634: Hold'em No Limit ($0.02/$0.05) - 2017/03/09 23:21:05
Table '#952' 6-max Seat #6 is the button
Seat 1: Small Blind ($4.98 in chips)
Seat 2: Big Blind ($2.39 in chips)
Seat 3: UTG ($4.85 in chips)
Seat 4: UTGplus1 ($7.50 in chips)
Seat 5: UTGplus2 ($1.33 in chips)
Seat 6: Hero ($4.47 in chips)
Small Blind: posts small blind $0.02
Big Blind: posts big blind $0.05
*** HOLE CARDS ***
Dealt to Hero [Ah Kd]
UTG: folds
UTGplus1: folds
UTGplus2: raises $0.10 to $0.10
Hero: raises $0.32 to $0.32
Small Blind: folds
Big Blind: raises $2.07 to $2.39 and is all-in
UTGplus2: folds
Hero: calls $2.07 
*** FLOP *** [7d Jh Qs]
*** TURN *** [7d Jh Qs] [8h]
*** RIVER *** [7d Jh Qs 8h] [Qc]
*** SHOW DOWN ***
Big Blind: shows [As Kh] (a pair of Queens)
Hero: shows [Ah Kd] (a pair of Queens)
Big Blind collected $2.33 from pot
Hero collected $2.33 from pot
*** SUMMARY ***
Total pot $4.9 | Rake $0.24
Board [7d Jh Qs 8h Qc]
Seat 1: Small Blind (small blind) showed
Seat 2: Big Blind (big blind) showed [As Kh] and won ($2.33) with a pair of Queens
Seat 3: UTG showed
Seat 4: UTGplus1 showed
Seat 5: UTGplus2 showed
Seat 6: Hero (button) showed [Ah Kd] and won ($2.33) with a pair of Queens



PokerStars Zoom Hand #3434766009: Hold'em No Limit ($0.02/$0.05) - 2017/03/09 23:21:53
Table '#952' 6-max Seat #6 is the button
Seat 1: Hero ($4.41 in chips)
Seat 2: Big Blind ($4.20 in chips)
Seat 3: UTG ($10.64 in chips)
Seat 4: UTGplus1 ($2.09 in chips)
Seat 5: UTGplus2 ($4.97 in chips)
Seat 6: Dealer ($2.60 in chips)
Hero: posts small blind $0.02
Big Blind: posts big blind $0.05
*** HOLE CARDS ***
Dealt to Hero [6h 8c]
UTG: folds
UTGplus1: folds
UTGplus2: folds
Dealer: raises $0.13 to $0.13
Hero: folds
Big Blind: calls $0.08 
*** FLOP *** [6d 4c As]
Big Blind: checks
Dealer: bets $0.10 
Big Blind: folds
Uncalled bet ($0.10) returned to Dealer
Dealer: doesn't show hand
Dealer collected $0.27 from pot
*** SUMMARY ***
Total pot $0.28 | Rake $0.01
Board [6d 4c As]
Seat 1: Hero (small blind) showed
Seat 2: Big Blind (big blind) showed
Seat 3: UTG showed
Seat 4: UTGplus1 showed
Seat 5: UTGplus2 showed
Seat 6: Dealer (button) won ($0.27)



PokerStars Zoom Hand #3434766059: Hold'em No Limit ($0.02/$0.05) - 2017/03/09 23:21:59
Table '#952' 6-max Seat #2 is the button
Seat 1: UTGplus2 ($7.43 in chips)
Seat 2: Dealer ($4.73 in chips)
Seat 3: Small Blind ($4.97 in chips)
Seat 4: Hero ($4.39 in chips)
Seat 5: UTG ($3.14 in chips)
Seat 6: UTGplus1 ($4.08 in chips)
Small Blind: posts small blind $0.02
Hero: posts big blind $0.05
*** HOLE CARDS ***
Dealt to Hero [2d 8c]
UTG: folds
UTGplus1: folds
UTGplus2: raises $0.15 to $0.15
Dealer: folds
Small Blind: folds
Hero: folds
Uncalled bet ($0.10) returned to UTGplus2
UTGplus2: doesn't show hand
UTGplus2 collected $0.12 from pot
*** SUMMARY ***
Total pot $0.12 | Rake $0.00
Seat 1: UTGplus2 won ($0.12)
Seat 2: Dealer (button) showed
Seat 3: Small Blind (small blind) showed
Seat 4: Hero (big blind) showed
Seat 5: UTG showed
Seat 6: UTGplus1 showed



PokerStars Zoom Hand #3434766099: Hold'em No Limit ($0.02/$0.05) - 2017/03/09 23:22:04
Table '#952' 6-max Seat #4 is the button
Seat 1: UTG ($1.70 in chips)
Seat 2: Hero ($4.34 in chips)
Seat 3: UTGplus2 ($10.64 in chips)
Seat 4: Dealer ($5.38 in chips)
Seat 5: Small Blind ($6.16 in chips)
Seat 6: Big Blind ($5.94 in chips)
Small Blind: posts small blind $0.02
Big Blind: posts big blind $0.05
*** HOLE CARDS ***
Dealt to Hero [7c 8s]
UTG: folds
Hero: folds
UTGplus2: folds
Dealer: folds
Small Blind: raises $0.13 to $0.15
Big Blind: calls $0.10 
*** FLOP *** [Ad 9h 3h]
Small Blind: checks
Big Blind: bets $0.15 
Small Blind: calls $0.15 
*** TURN *** [Ad 9h 3h] [3c]
Small Blind: checks
Big Blind: bets $0.15 
Small Blind: raises $0.50 to $0.50
Big Blind: folds
Uncalled bet ($0.35) returned to Small Blind
Small Blind: doesn't show hand
Small Blind collected $0.86 from pot
*** SUMMARY ***
Total pot $0.9 | Rake $0.04
Board [Ad 9h 3h 3c]
Seat 1: UTG showed
Seat 2: Hero showed
Seat 3: UTGplus2 showed
Seat 4: Dealer (button) showed
Seat 5: Small Blind (small blind) won ($0.86)
Seat 6: Big Blind (big blind) showed



PokerStars Zoom Hand #3434766181: Hold'em No Limit ($0.02/$0.05) - 2017/03/09 23:22:14
Table '#952' 6-max Seat #5 is the button
Seat 1: Big Blind ($3.37 in chips)
Seat 2: UTG ($8.48 in chips)
Seat 3: UTGplus1 ($5.72 in chips)
Seat 4: UTGplus2 ($16.51 in chips)
Seat 5: Hero ($4.34 in chips)
Seat 6: Small Blind ($4.02 in chips)
Small Blind: posts small blind $0.02
Big Blind: posts big blind $0.05
*** HOLE CARDS ***
Dealt to Hero [5h 9d]
UTG: folds
UTGplus1: folds
UTGplus2: folds
Hero: folds
Small Blind: raises $0.08 to $0.10
Big Blind: calls $0.05 
*** FLOP *** [Td 7c 6c]
Small Blind: bets $0.20 
Big Blind: folds
Uncalled bet ($0.20) returned to Small Blind
Small Blind: doesn't show hand
Small Blind collected $0.19 from pot
*** SUMMARY ***
Total pot $0.2 | Rake $0.01
Board [Td 7c 6c]
Seat 1: Big Blind (big blind) showed
Seat 2: UTG showed
Seat 3: UTGplus1 showed
Seat 4: UTGplus2 showed
Seat 5: Hero (button) showed
Seat 6: Small Blind (small blind) won ($0.19)



PokerStars Zoom Hand #3434766221: Hold'em No Limit ($0.02/$0.05) - 2017/03/09 23:22:19
Table '#952' 6-max Seat #4 is the button
Seat 1: UTG ($16.51 in chips)
Seat 2: UTGplus1 ($5.72 in chips)
Seat 3: UTGplus2 ($4.07 in chips)
Seat 4: Dealer ($7.44 in chips)
Seat 5: Hero ($4.34 in chips)
Seat 6: Big Blind ($1.44 in chips)
Hero: posts small blind $0.02
Big Blind: posts big blind $0.05
*** HOLE CARDS ***
Dealt to Hero [5h 9h]
UTG: folds
UTGplus1: folds
UTGplus2: folds
Dealer: folds
Hero: raises $0.13 to $0.15
Big Blind: folds
Uncalled bet ($0.10) returned to Hero
Hero: doesn't show hand
Hero collected $0.1 from pot
*** SUMMARY ***
Total pot $0.1 | Rake $0.00
Seat 1: UTG showed
Seat 2: UTGplus1 showed
Seat 3: UTGplus2 showed
Seat 4: Dealer (button) showed
Seat 5: Hero (small blind) won ($0.1)
Seat 6: Big Blind (big blind) showed



PokerStars Zoom Hand #3434766375: Hold'em No Limit ($0.02/$0.05) - 2017/03/09 23:22:39
Table '#952' 6-max Seat #3 is the button
Seat 1: UTGplus1 ($7.14 in chips)
Seat 2: Hero ($4.39 in chips)
Seat 3: Dealer ($1.74 in chips)
Seat 4: Small Blind ($12.79 in chips)
Seat 5: Big Blind ($6.19 in chips)
Seat 6: UTG ($2.85 in chips)
Small Blind: posts small blind $0.02
Big Blind: posts big blind $0.05
*** HOLE CARDS ***
Dealt to Hero [9d 3d]
UTG: folds
UTGplus1: folds
Hero: folds
Dealer: folds
Small Blind: folds
Big Blind: doesn't show hand
Big Blind collected $0.07 from pot
*** SUMMARY ***
Total pot $0.07 | Rake $0.00
Seat 1: UTGplus1 showed
Seat 2: Hero showed
Seat 3: Dealer (button) showed
Seat 4: Small Blind (small blind) showed
Seat 5: Big Blind (big blind) won ($0.07)
Seat 6: UTG showed



PokerStars Zoom Hand #3434766424: Hold'em No Limit ($0.02/$0.05) - 2017/03/09 23:22:45
Table '#952' 6-max Seat #1 is the button
Seat 1: Dealer ($6.93 in chips)
Seat 2: Hero ($4.39 in chips)
Seat 3: Big Blind ($7.14 in chips)
Seat 4: UTG ($5.38 in chips)
Seat 5: UTGplus1 ($4.66 in chips)
Seat 6: UTGplus2 ($13.03 in chips)
Hero: posts small blind $0.02
Big Blind: posts big blind $0.05
*** HOLE CARDS ***
Dealt to Hero [Qh Qc]
UTG: folds
UTGplus1: raises $0.15 to $0.15
UTGplus2: folds
Dealer: folds
Hero: raises $0.43 to $0.45
Big Blind: folds
UTGplus1: folds
Uncalled bet ($0.30) returned to Hero
Hero: doesn't show hand
Hero collected $0.35 from pot
Table deposit $5 
*** SUMMARY ***
Total pot $0.35 | Rake $0.00
Seat 1: Dealer (button) showed
Seat 2: Hero (small blind) won ($0.35)
Seat 3: Big Blind (big blind) showed
Seat 4: UTG showed
Seat 5: UTGplus1 showed
Seat 6: UTGplus2 showed



PokerStars Zoom Hand #3434766677: Hold'em No Limit ($0.02/$0.05) - 2017/03/09 23:23:17
Table '#952' 6-max Seat #6 is the button
Seat 1: Hero ($4.59 in chips)
Seat 2: Big Blind ($5 in chips)
Seat 3: UTG ($2.45 in chips)
Seat 4: UTGplus1 ($5.06 in chips)
Seat 5: UTGplus2 ($5.99 in chips)
Seat 6: Dealer ($2.26 in chips)
Hero: posts small blind $0.02
Big Blind: posts big blind $0.05
*** HOLE CARDS ***
Dealt to Hero [5c Kd]
UTG: folds
UTGplus1: folds
UTGplus2: folds
Dealer: raises $0.10 to $0.10
Hero: folds
Big Blind: calls $0.05 
*** FLOP *** [8s Ac 5s]
Big Blind: checks 
Dealer: bets $0.11 
Big Blind: folds
Uncalled bet ($0.11) returned to Dealer
Dealer: doesn't show hand
Dealer collected $0.21 from pot
Table deposit $5 
Seat re-join
*** SUMMARY ***
Total pot $0.22 | Rake $0.01
Board [8s Ac 5s]
Seat 1: Hero (small blind) showed
Seat 2: Big Blind (big blind) showed
Seat 3: UTG showed
Seat 4: UTGplus1 showed
Seat 5: UTGplus2 showed
Seat 6: Dealer (button) won ($0.21)



PokerStars Zoom Hand #3434766726: Hold'em No Limit ($0.02/$0.05) - 2017/03/09 23:23:23
Table '#952' 6-max Seat #5 is the button
Seat 1: Hero ($4.57 in chips)
Seat 2: UTG ($5.90 in chips)
Seat 3: UTGplus1 ($4.15 in chips)
Seat 4: UTGplus2 ($5.64 in chips)
Seat 5: Dealer ($6.43 in chips)
Seat 6: Small Blind ($9.07 in chips)
Small Blind: posts small blind $0.02
Hero: posts big blind $0.05
*** HOLE CARDS ***
Dealt to Hero [9s 4d]
UTG: folds
UTGplus1: folds
UTGplus2: folds
Dealer: raises $0.15 to $0.15
Small Blind: calls $0.13 
Hero: folds
*** FLOP *** [7c 9h 8h]
Small Blind: checks
Dealer: checks
*** TURN *** [7c 9h 8h] [Jc]
Small Blind: bets $0.14 
Dealer: calls $0.14 
*** RIVER *** [7c 9h 8h Jc] [Qd]
Small Blind: checks
Dealer: bets $0.21 
Small Blind: folds
Uncalled bet ($0.21) returned to Dealer
Dealer: doesn't show hand
Dealer collected $0.6 from pot
*** SUMMARY ***
Total pot $0.63 | Rake $0.03
Board [7c 9h 8h Jc Qd]
Seat 1: Hero (big blind) showed
Seat 2: UTG showed
Seat 3: UTGplus1 showed
Seat 4: UTGplus2 showed
Seat 5: Dealer (button) won ($0.6)
Seat 6: Small Blind (small blind) showed



PokerStars Zoom Hand #3434766766: Hold'em No Limit ($0.02/$0.05) - 2017/03/09 23:23:28
Table '#952' 6-max Seat #6 is the button
Seat 1: Small Blind ($1.47 in chips)
Seat 2: Big Blind ($5.06 in chips)
Seat 3: UTG ($3.94 in chips)
Seat 4: Hero ($4.52 in chips)
Seat 5: UTGplus2 ($5 in chips)
Seat 6: Dealer ($1.39 in chips)
Small Blind: posts small blind $0.02
Big Blind: posts big blind $0.05
*** HOLE CARDS ***
Dealt to Hero [3d 7c]
UTG: folds
Hero: folds
UTGplus2: folds
Dealer: folds
Small Blind: raises $0.13 to $0.15
Big Blind: raises $0.40 to $0.45
Small Blind: calls $0.30 
*** FLOP *** [Kd 8h Jh]
Small Blind: checks
Big Blind: checks
*** TURN *** [Kd 8h Jh] [3s]
Small Blind: checks
Big Blind: checks
*** RIVER *** [Kd 8h Jh 3s] [Tc]
Small Blind: checks
Big Blind: checks
*** SHOW DOWN ***
Small Blind: shows [9d 8d] (a pair of Eights)
Big Blind: shows [Ac 9c] (High Card)
Small Blind collected $0.86 from pot
*** SUMMARY ***
Total pot $0.9 | Rake $0.04
Board [Kd 8h Jh 3s Tc]
Seat 1: Small Blind (small blind) showed [9d 8d] and won ($0.86) with a pair of Eights
Seat 2: Big Blind (big blind) showed [Ac 9c]
Seat 3: UTG showed
Seat 4: Hero showed
Seat 5: UTGplus2 showed
Seat 6: Dealer (button) showed



PokerStars Zoom Hand #3434766806: Hold'em No Limit ($0.02/$0.05) - 2017/03/09 23:23:32
Table '#952' 6-max Seat #3 is the button
Seat 1: UTGplus1 ($4.90 in chips)
Seat 2: UTGplus2 ($3.86 in chips)
Seat 3: Dealer ($2.43 in chips)
Seat 4: Small Blind ($1.39 in chips)
Seat 5: Big Blind ($6.66 in chips)
Seat 6: Hero ($4.52 in chips)
Small Blind: posts small blind $0.02
Big Blind: posts big blind $0.05
*** HOLE CARDS ***
Dealt to Hero [9d 4h]
Hero: folds
UTGplus1: folds
UTGplus2: folds
Dealer: folds
Small Blind: folds
Big Blind: doesn't show hand
Big Blind collected $0.07 from pot
*** SUMMARY ***
Total pot $0.07 | Rake $0.00
Seat 1: UTGplus1 showed
Seat 2: UTGplus2 showed
Seat 3: Dealer (button) showed
Seat 4: Small Blind (small blind) showed
Seat 5: Big Blind (big blind) won ($0.07)
Seat 6: Hero showed



PokerStars Zoom Hand #3434766853: Hold'em No Limit ($0.02/$0.05) - 2017/03/09 23:23:37
Table '#952' 6-max Seat #5 is the button
Seat 1: Big Blind ($2.43 in chips)
Seat 2: UTG ($4.90 in chips)
Seat 3: UTGplus1 ($3.01 in chips)
Seat 4: Hero ($4.52 in chips)
Seat 5: Dealer ($6.57 in chips)
Seat 6: Small Blind ($13.10 in chips)
Small Blind: posts small blind $0.02
Big Blind: posts big blind $0.05
*** HOLE CARDS ***
Dealt to Hero [6s Jh]
UTG: folds
UTGplus1: folds
Hero: folds
Dealer: folds 
Small Blind: folds
Big Blind: doesn't show hand
Big Blind collected $0.07 from pot
*** SUMMARY ***
Total pot $0.07 | Rake $0.00
Seat 1: Big Blind (big blind) won ($0.07)
Seat 2: UTG showed
Seat 3: UTGplus1 showed
Seat 4: Hero showed
Seat 5: Dealer (button) showed
Seat 6: Small Blind (small blind) showed



PokerStars Zoom Hand #3434766888: Hold'em No Limit ($0.02/$0.05) - 2017/03/09 23:23:42
Table '#952' 6-max Seat #6 is the button
Seat 1: Small Blind ($2.88 in chips)
Seat 2: Big Blind ($6.59 in chips)
Seat 3: UTG ($5 in chips)
Seat 4: UTGplus1 ($3.01 in chips)
Seat 5: Hero ($4.52 in chips)
Seat 6: Dealer ($1.55 in chips)
Small Blind: posts small blind $0.02
Big Blind: posts big blind $0.05
*** HOLE CARDS ***
Dealt to Hero [8c 7s]
UTG: folds
UTGplus1: folds
Hero: folds
Dealer: folds
Small Blind: folds
Big Blind: doesn't show hand
Big Blind collected $0.07 from pot
*** SUMMARY ***
Total pot $0.07 | Rake $0.00
Seat 1: Small Blind (small blind) showed
Seat 2: Big Blind (big blind) won ($0.07)
Seat 3: UTG showed
Seat 4: UTGplus1 showed
Seat 5: Hero showed
Seat 6: Dealer (button) showed



PokerStars Zoom Hand #3434766925: Hold'em No Limit ($0.02/$0.05) - 2017/03/09 23:23:48
Table '#952' 6-max Seat #5 is the button
Seat 1: Big Blind ($5 in chips)
Seat 2: UTG ($7.85 in chips)
Seat 3: UTGplus1 ($4.78 in chips)
Seat 4: UTGplus2 ($7.68 in chips)
Seat 5: Hero ($4.52 in chips)
Seat 6: Small Blind ($20.36 in chips)
Small Blind: posts small blind $0.02
Big Blind: posts big blind $0.05
*** HOLE CARDS ***
Dealt to Hero [Ah 6d]
UTG: folds
UTGplus1: folds
UTGplus2: raises $0.16 to $0.16
Hero: folds
Small Blind: folds
Big Blind: folds
Uncalled bet ($0.11) returned to UTGplus2
UTGplus2: doesn't show hand
UTGplus2 collected $0.12 from pot
Seat re-join
*** SUMMARY ***
Total pot $0.12 | Rake $0.00
Seat 1: Big Blind (big blind) showed
Seat 2: UTG showed
Seat 3: UTGplus1 showed
Seat 4: UTGplus2 won ($0.12)
Seat 5: Hero (button) showed
Seat 6: Small Blind (small blind) showed



PokerStars Zoom Hand #3434767051: Hold'em No Limit ($0.02/$0.05) - 2017/03/09 23:24:05
Table '#952' 6-max Seat #5 is the button
Seat 1: Hero ($4.52 in chips)
Seat 2: UTG ($1.90 in chips)
Seat 3: UTGplus1 ($13.67 in chips)
Seat 4: UTGplus2 ($13.34 in chips)
Seat 5: Dealer ($8.51 in chips)
Seat 6: Small Blind ($6.61 in chips)
Small Blind: posts small blind $0.02
Hero: posts big blind $0.05
*** HOLE CARDS ***
Dealt to Hero [6h Ah]
UTG: folds
UTGplus1: folds
UTGplus2: folds
Dealer: calls $0.05 
Small Blind: raises $0.23 to $0.25
Hero: calls $0.20 
Dealer: calls $0.20 
*** FLOP *** [8h 4c Qh]
Small Blind: bets $0.52 
Hero: calls $0.52 
Dealer: folds
*** TURN *** [8h 4c Qh] [Qc]
Small Blind: checks
Hero: checks
*** RIVER *** [8h 4c Qh Qc] [7c]
Small Blind: checks
Hero: checks
*** SHOW DOWN ***
Small Blind: shows [Kd As] (a pair of Queens)
Hero: shows [6h Ah] (One pair)
Small Blind collected $1.71 from pot
*** SUMMARY ***
Total pot $1.79 | Rake $0.08
Board [8h 4c Qh Qc 7c]
Seat 1: Hero (big blind) showed [6h Ah]
Seat 2: UTG showed
Seat 3: UTGplus1 showed
Seat 4: UTGplus2 showed
Seat 5: Dealer (button) showed
Seat 6: Small Blind (small blind) showed [Kd As] and won ($1.71) with a pair of Queens



PokerStars Zoom Hand #3434767608: Hold'em No Limit ($0.02/$0.05) - 2017/03/09 23:25:17
Table '#952' 6-max Seat #4 is the button
Seat 1: UTG ($16.38 in chips)
Seat 2: Hero ($3.75 in chips)
Seat 3: UTGplus2 ($7.55 in chips)
Seat 4: Dealer ($6.57 in chips)
Seat 5: Small Blind ($5.06 in chips)
Seat 6: Big Blind ($10.20 in chips)
Small Blind: posts small blind $0.02
Big Blind: posts big blind $0.05
*** HOLE CARDS ***
Dealt to Hero [7d 8s]
UTG: folds
Hero: folds
UTGplus2: raises $0.20 to $0.20
Dealer: calls $0.20 
Small Blind: folds
Big Blind: folds
*** FLOP *** [5h Qd 8d]
UTGplus2: bets $0.42 
Dealer: folds
Uncalled bet ($0.42) returned to UTGplus2
UTGplus2: doesn't show hand
UTGplus2 collected $0.45 from pot
*** SUMMARY ***
Total pot $0.47 | Rake $0.02
Board [5h Qd 8d]
Seat 1: UTG showed
Seat 2: Hero showed
Seat 3: UTGplus2 won ($0.45)
Seat 4: Dealer (button) showed
Seat 5: Small Blind (small blind) showed
Seat 6: Big Blind (big blind) showed



PokerStars Zoom Hand #3434767655: Hold'em No Limit ($0.02/$0.05) - 2017/03/09 23:25:23
Table '#952' 6-max Seat #1 is the button
Seat 1: Dealer ($8.84 in chips)
Seat 2: Small Blind ($4.80 in chips)
Seat 3: Big Blind ($1.63 in chips)
Seat 4: UTG ($10.99 in chips)
Seat 5: Hero ($3.75 in chips)
Seat 6: UTGplus2 ($1.76 in chips)
Small Blind: posts small blind $0.02
Big Blind: posts big blind $0.05
*** HOLE CARDS ***
Dealt to Hero [6d 8c]
UTG: folds
Hero: folds
UTGplus2: calls $0.05 
Dealer: folds
Small Blind: folds
Big Blind: checks
*** FLOP *** [7d 7h 9h]
Big Blind: checks
UTGplus2: checks
*** TURN *** [7d 7h 9h] [6s]
Big Blind: checks
UTGplus2: checks
*** RIVER *** [7d 7h 9h 6s] [9c]
Big Blind: checks
UTGplus2: checks
*** SHOW DOWN ***
Big Blind: shows [4c 3s] (two pair, Nines and Sixs)
UTGplus2: shows [Ad Kd] (two pair, Nines and Aces)
UTGplus2 collected $0.12 from pot
*** SUMMARY ***
Total pot $0.12 | Rake $0.00
Board [7d 7h 9h 6s 9c]
Seat 1: Dealer (button) showed
Seat 2: Small Blind (small blind) showed
Seat 3: Big Blind (big blind) showed [4c 3s] and lost with two pair, Nines and Sixes
Seat 4: UTG showed
Seat 5: Hero showed
Seat 6: UTGplus2 showed [Ad Kd] and won ($0.12) with two pair, Nines and Aces



PokerStars Zoom Hand #3434767744: Hold'em No Limit ($0.02/$0.05) - 2017/03/09 23:25:35
Table '#952' 6-max Seat #5 is the button
Seat 1: Big Blind ($5 in chips)
Seat 2: UTG ($1.88 in chips)
Seat 3: UTGplus1 ($6.33 in chips)
Seat 4: Hero ($5 in chips)
Seat 5: Dealer ($6.73 in chips)
Seat 6: Small Blind ($1.04 in chips)
Small Blind: posts small blind $0.02
Big Blind: posts big blind $0.05
*** HOLE CARDS ***
Dealt to Hero [7h 4c]
UTG: folds
UTGplus1: folds
Hero: folds
Dealer: folds
Small Blind: raises $0.08 to $0.10
Big Blind: raises $0.10 to $0.15
Small Blind: calls $0.05 
*** FLOP *** [7s 5s Kc]
Small Blind: checks
Big Blind: bets $0.05 
Small Blind: calls $0.05 
*** TURN *** [7s 5s Kc] [5h]
Small Blind: checks
Big Blind: bets $0.40 
Small Blind: folds
Uncalled bet ($0.40) returned to Big Blind
Big Blind: doesn't show hand
Big Blind collected $0.38 from pot
*** SUMMARY ***
Total pot $0.4 | Rake $0.02
Board [7s 5s Kc 5h]
Seat 1: Big Blind (big blind) won ($0.38)
Seat 2: UTG showed
Seat 3: UTGplus1 showed
Seat 4: Hero showed
Seat 5: Dealer (button) showed
Seat 6: Small Blind (small blind) showed



PokerStars Zoom Hand #3434767781: Hold'em No Limit ($0.02/$0.05) - 2017/03/09 23:25:40
Table '#952' 6-max Seat #2 is the button
Seat 1: UTGplus2 ($2.87 in chips)
Seat 2: Hero ($5 in chips)
Seat 3: Small Blind ($5.07 in chips)
Seat 4: Big Blind ($4.52 in chips)
Seat 5: UTG ($20.22 in chips)
Seat 6: UTGplus1 ($6.73 in chips)
Small Blind: posts small blind $0.02
Big Blind: posts big blind $0.05
*** HOLE CARDS ***
Dealt to Hero [8d 5h]
UTG: raises $0.12 to $0.12
UTGplus1: folds
UTGplus2: calls $0.12 
Hero: folds
Small Blind: folds
Big Blind: raises $0.45 to $0.50
UTG: folds
UTGplus2: folds
Uncalled bet ($0.38) returned to Big Blind
Big Blind: doesn't show hand
Big Blind collected $0.38 from pot
*** SUMMARY ***
Total pot $0.38 | Rake $0.00
Seat 1: UTGplus2 showed
Seat 2: Hero (button) showed
Seat 3: Small Blind (small blind) showed
Seat 4: Big Blind (big blind) won ($0.38)
Seat 5: UTG showed
Seat 6: UTGplus1 showed



PokerStars Zoom Hand #3434767821: Hold'em No Limit ($0.02/$0.05) - 2017/03/09 23:25:46
Table '#952' 6-max Seat #3 is the button
Seat 1: UTGplus1 ($5.59 in chips)
Seat 2: Hero ($5 in chips)
Seat 3: Dealer ($11.40 in chips)
Seat 4: Small Blind ($0.88 in chips)
Seat 5: Big Blind ($10.53 in chips)
Seat 6: UTG ($10.29 in chips)
Small Blind: posts small blind $0.02
Big Blind: posts big blind $0.05
*** HOLE CARDS ***
Dealt to Hero [3d 6d]
UTG: calls $0.05 
UTGplus1: folds
Hero: folds
Dealer: folds
Small Blind: folds
Big Blind: checks
*** FLOP *** [6h 4s Qd]
Big Blind: checks
UTG: checks
*** TURN *** [6h 4s Qd] [Jc]
Big Blind: checks
UTG: checks
*** RIVER *** [6h 4s Qd Jc] [Th]
Big Blind: checks
UTG: checks
*** SHOW DOWN ***
Big Blind: shows [3h Kc] (high card King)
UTG: shows [3s Ah] (high card Ace)
UTG collected $0.12 from pot
Table deposit $2.50 
*** SUMMARY ***
Total pot $0.12 | Rake $0.00
Board [6h 4s Qd Jc Th]
Seat 1: UTGplus1 showed
Seat 2: Hero showed
Seat 3: Dealer (button) showed
Seat 4: Small Blind (small blind) showed
Seat 5: Big Blind (big blind) showed [3h Kc-Kc Qd Jc Th 6h] and lost with high card Three
Seat 6: UTG showed [3s Ah] and won ($0.12) with high card Ace



PokerStars Zoom Hand #3434767862: Hold'em No Limit ($0.02/$0.05) - 2017/03/09 23:25:50
Table '#952' 6-max Seat #6 is the button
Seat 1: Small Blind ($11.33 in chips)
Seat 2: Big Blind ($4.89 in chips)
Seat 3: UTG ($2.84 in chips)
Seat 4: UTGplus1 ($5.28 in chips)
Seat 5: UTGplus2 ($0.86 in chips)
Seat 6: Hero ($5 in chips)
Small Blind: posts small blind $0.02
Big Blind: posts big blind $0.05
*** HOLE CARDS ***
Dealt to Hero [Jd 7s]
UTG: folds
UTGplus1: folds
UTGplus2: folds
Hero: folds
Small Blind: calls $0.03 
Big Blind: checks
*** FLOP *** [Ks 8h As]
Small Blind: checks
Big Blind: bets $0.10 
Small Blind: calls $0.10 
*** TURN *** [Ks 8h As] [4d]
Small Blind: checks
Big Blind: checks
*** RIVER *** [Ks 8h As 4d] [7h]
Small Blind: checks
Big Blind: checks
*** SHOW DOWN ***
Small Blind: shows [Ad Td] (a pair of Aces)
Big Blind: shows [5h 3c] (High Card)
Small Blind collected $0.29 from pot
*** SUMMARY ***
Total pot $0.3 | Rake $0.01
Board [Ks 8h As 4d 7h]
Seat 1: Small Blind (small blind) showed [Ad Td] and won ($0.29) with a pair of Aces
Seat 2: Big Blind (big blind) showed [5h 3c]
Seat 3: UTG showed
Seat 4: UTGplus1 showed
Seat 5: UTGplus2 showed
Seat 6: Hero (button) showed



PokerStars Zoom Hand #3434767906: Hold'em No Limit ($0.02/$0.05) - 2017/03/09 23:25:56
Table '#952' 6-max Seat #6 is the button
Seat 1: Hero ($5 in chips)
Seat 2: Big Blind ($2.50 in chips)
Seat 3: UTG ($6.45 in chips)
Seat 4: UTGplus1 ($6.31 in chips)
Seat 5: UTGplus2 ($6.49 in chips)
Seat 6: Dealer ($4.70 in chips)
Hero: posts small blind $0.02
Big Blind: posts big blind $0.05
*** HOLE CARDS ***
Dealt to Hero [5s 8h]
UTG: raises $0.15 to $0.15
UTGplus1: folds
UTGplus2: folds
Dealer: folds
Hero: folds
Big Blind: calls $0.10 
*** FLOP *** [4h Ah 5c]
Big Blind: checks
UTG: bets $0.15 
Big Blind: calls $0.15 
*** TURN *** [4h Ah 5c] [8d]
Big Blind: checks
UTG: checks
*** RIVER *** [4h Ah 5c 8d] [5h]
Big Blind: checks
UTG: checks
*** SHOW DOWN ***
Big Blind: shows [8c Ad] (two pair, Aces and Fives)
UTG: shows [6d 4d] (two pair, Fives and Aces)
Big Blind collected $0.59 from pot
*** SUMMARY ***
Total pot $0.62 | Rake $0.03
Board [4h Ah 5c 8d 5h]
Seat 1: Hero (small blind) showed
Seat 2: Big Blind (big blind) showed [8c Ad] and won ($0.59) with two pair, Fives and Aces
Seat 3: UTG showed [6d 4d] and lost with two pair, Fives and Aces
Seat 4: UTGplus1 showed
Seat 5: UTGplus2 showed
Seat 6: Dealer (button) showed



PokerStars Zoom Hand #3434767941: Hold'em No Limit ($0.02/$0.05) - 2017/03/09 23:26:01
Table '#952' 6-max Seat #6 is the button
Seat 1: Small Blind ($7.41 in chips)
Seat 2: Hero ($4.98 in chips)
Seat 3: UTG ($6.31 in chips)
Seat 4: UTGplus1 ($6.49 in chips)
Seat 5: UTGplus2 ($8.69 in chips)
Seat 6: Dealer ($8.11 in chips)
Small Blind: posts small blind $0.02
Hero: posts big blind $0.05
*** HOLE CARDS ***
Dealt to Hero [6c 5h]
UTG: folds
UTGplus1: folds
UTGplus2: folds
Dealer: raises $0.15 to $0.15
Small Blind: folds
Hero: folds
Uncalled bet ($0.10) returned to Dealer
Dealer: doesn't show hand
Dealer collected $0.12 from pot
*** SUMMARY ***
Total pot $0.12 | Rake $0.00
Seat 1: Small Blind (small blind) showed
Seat 2: Hero (big blind) showed
Seat 3: UTG showed
Seat 4: UTGplus1 showed
Seat 5: UTGplus2 showed
Seat 6: Dealer (button) won ($0.12)



PokerStars Zoom Hand #3434767970: Hold'em No Limit ($0.02/$0.05) - 2017/03/09 23:26:05
Table '#952' 6-max Seat #1 is the button
Seat 1: Dealer ($8.76 in chips)
Seat 2: Small Blind ($15.11 in chips)
Seat 3: Big Blind ($5.54 in chips)
Seat 4: UTG ($8.69 in chips)
Seat 5: UTGplus1 ($2.40 in chips)
Seat 6: Hero ($4.93 in chips)
Small Blind: posts small blind $0.02
Big Blind: posts big blind $0.05
*** HOLE CARDS ***
Dealt to Hero [Jh Jd]
UTG: raises $0.15 to $0.15
UTGplus1: calls $0.15 
Hero: calls $0.15 
Dealer: calls $0.15 
Small Blind: folds
Big Blind: folds
*** FLOP *** [6h Td As]
UTG: bets $0.67 
UTGplus1: calls $0.67 
Hero: calls $0.67 
Dealer: folds
*** TURN *** [6h Td As] [5s]
UTG: bets $2.68 
UTGplus1: calls $1.58 and is all-in
Hero: folds
*** RIVER *** [6h Td As 5s] [Kh]
*** SHOW DOWN ***
UTG: shows [6d Ad] (two pair, Aces and Kings)
UTGplus1: shows [5h Ah] (two pair, Aces and Kings)
Uncalled bet ($1.10) returned to UTG
UTG collected $5.55 from pot
*** SUMMARY ***
Total pot $5.84 | Rake $0.29
Board [6h Td As 5s Kh]
Seat 1: Dealer (button) showed
Seat 2: Small Blind (small blind) showed
Seat 3: Big Blind (big blind) showed
Seat 4: UTG showed [6d Ad] and won ($5.55) with two pair, Aces and Kings
Seat 5: UTGplus1 showed [5h Ah] and lost with two pair, Aces and Kings
Seat 6: Hero showed



PokerStars Zoom Hand #3434768525: Hold'em No Limit ($0.02/$0.05) - 2017/03/09 23:27:18
Table '#952' 6-max Seat #3 is the button
Seat 1: Hero ($4.11 in chips)
Seat 2: UTGplus2 ($5.62 in chips)
Seat 3: Dealer ($1.89 in chips)
Seat 4: Small Blind ($5.67 in chips)
Seat 5: Big Blind ($5 in chips)
Seat 6: UTG ($1.27 in chips)
Small Blind: posts small blind $0.02
Big Blind: posts big blind $0.05
*** HOLE CARDS ***
Dealt to Hero [4s Tc]
UTG: folds
Hero: folds
UTGplus2: folds
Dealer: calls $0.05 
Small Blind: folds
Big Blind: checks
*** FLOP *** [3h 9s 6s]
Big Blind: checks
Dealer: checks
*** TURN *** [3h 9s 6s] [7c]
Big Blind: checks
Dealer: checks
*** RIVER *** [3h 9s 6s 7c] [Ac]
Big Blind: checks
Dealer: checks
*** SHOW DOWN ***
Big Blind: shows [2h 5d] (high card Ace)
Dealer: shows [Ts Qh] (high card Ace)
Dealer collected $0.12 from pot
*** SUMMARY ***
Total pot $0.12 | Rake $0.00
Board [3h 9s 6s 7c Ac]
Seat 1: Hero showed
Seat 2: UTGplus2 showed
Seat 3: Dealer (button) showed [Ts Qh] and won ($0.12) with high card Ace
Seat 4: Small Blind (small blind) showed
Seat 5: Big Blind (big blind) showed [2h 5d] and lost with high card Deuce
Seat 6: UTG showed



PokerStars Zoom Hand #3434768615: Hold'em No Limit ($0.02/$0.05) - 2017/03/09 23:27:29
Table '#952' 6-max Seat #6 is the button
Seat 1: Small Blind ($6.41 in chips)
Seat 2: Big Blind ($5 in chips)
Seat 3: UTG ($1.92 in chips)
Seat 4: UTGplus1 ($10.93 in chips)
Seat 5: Hero ($5 in chips)
Seat 6: Dealer ($10.09 in chips)
Small Blind: posts small blind $0.02
Big Blind: posts big blind $0.05
*** HOLE CARDS ***
Dealt to Hero [2c Ad]
UTG: folds
UTGplus1: folds
Hero: folds
Dealer: folds
Small Blind: folds
Big Blind: doesn't show hand
Big Blind collected $0.07 from pot
*** SUMMARY ***
Total pot $0.07 | Rake $0.00
Seat 1: Small Blind (small blind) showed
Seat 2: Big Blind (big blind) won ($0.07)
Seat 3: UTG showed
Seat 4: UTGplus1 showed
Seat 5: Hero showed
Seat 6: Dealer (button) showed



PokerStars Zoom Hand #3434768681: Hold'em No Limit ($0.02/$0.05) - 2017/03/09 23:27:38
Table '#952' 6-max Seat #6 is the button
Seat 1: Small Blind ($15.83 in chips)
Seat 2: Big Blind ($1.33 in chips)
Seat 3: UTG ($15.44 in chips)
Seat 4: UTGplus1 ($11.19 in chips)
Seat 5: UTGplus2 ($3.24 in chips)
Seat 6: Hero ($5 in chips)
Small Blind: posts small blind $0.02
Big Blind: posts big blind $0.05
*** HOLE CARDS ***
Dealt to Hero [8d Ad]
UTG: folds
UTGplus1: folds
UTGplus2: folds
Hero: raises $0.17 to $0.17
Small Blind: raises $0.47 to $0.49
Big Blind: folds
Hero: calls $0.32 
*** FLOP *** [6d 7h Qs]
Small Blind: bets $0.60 
Hero: calls $0.60 
*** TURN *** [6d 7h Qs] [8s]
Small Blind: bets $1.57 
Hero: calls $1.57 
*** RIVER *** [6d 7h Qs 8s] [2d]
Small Blind: bets $13.17 and is all-in
Hero: calls $2.34 and is all-in
*** SHOW DOWN ***
Small Blind: shows [9d Kd] (high card King)
Hero: shows [8d Ad] (a pair of Eights)
Uncalled bet ($10.83) returned to Small Blind
Hero collected $9.55 from pot
*** SUMMARY ***
Total pot $10.05 | Rake $0.50
Board [6d 7h Qs 8s 2d]
Seat 1: Small Blind (small blind) showed [9d Kd-Kd Qs 9d 8s 7h] and lost with high card Nine
Seat 2: Big Blind (big blind) showed
Seat 3: UTG showed
Seat 4: UTGplus1 showed
Seat 5: UTGplus2 showed
Seat 6: Hero (button) showed [8d Ad] and won ($9.55) with a pair of Eights



PokerStars Zoom Hand #3434769215: Hold'em No Limit ($0.02/$0.05) - 2017/03/09 23:28:43
Table '#952' 6-max Seat #2 is the button
Seat 1: UTGplus2 ($6.44 in chips)
Seat 2: Dealer ($10.83 in chips)
Seat 3: Hero ($9.55 in chips)
Seat 4: Big Blind ($7.77 in chips)
Seat 5: UTG ($5.25 in chips)
Seat 6: UTGplus1 ($5.85 in chips)
Hero: posts small blind $0.02
Big Blind: posts big blind $0.05
*** HOLE CARDS ***
Dealt to Hero [Jc 9s]
UTG: folds
UTGplus1: folds
UTGplus2: folds
Dealer: folds
Hero: raises $0.13 to $0.15
Big Blind: folds
Uncalled bet ($0.10) returned to Hero
Hero: doesn't show hand
Hero collected $0.1 from pot
*** SUMMARY ***
Total pot $0.1 | Rake $0.00
Seat 1: UTGplus2 showed
Seat 2: Dealer (button) showed
Seat 3: Hero (small blind) won ($0.1)
Seat 4: Big Blind (big blind) showed
Seat 5: UTG showed
Seat 6: UTGplus1 showed



PokerStars Zoom Hand #3434769424: Hold'em No Limit ($0.02/$0.05) - 2017/03/09 23:29:10
Table '#952' 6-max Seat #5 is the button
Seat 1: Big Blind ($5.86 in chips)
Seat 2: Hero ($9.60 in chips)
Seat 3: UTGplus1 ($5.40 in chips)
Seat 4: UTGplus2 ($15.07 in chips)
Seat 5: Dealer ($4.95 in chips)
Seat 6: Small Blind ($7.72 in chips)
Small Blind: posts small blind $0.02
Big Blind: posts big blind $0.05
*** HOLE CARDS ***
Dealt to Hero [5h Th]
Hero: folds
UTGplus1: folds
UTGplus2: raises $0.15 to $0.15
Dealer: folds
Small Blind: folds
Big Blind: folds
Uncalled bet ($0.10) returned to UTGplus2
UTGplus2: doesn't show hand
UTGplus2 collected $0.12 from pot
*** SUMMARY ***
Total pot $0.12 | Rake $0.00
Seat 1: Big Blind (big blind) showed
Seat 2: Hero showed
Seat 3: UTGplus1 showed
Seat 4: UTGplus2 won ($0.12)
Seat 5: Dealer (button) showed
Seat 6: Small Blind (small blind) showed



PokerStars Zoom Hand #3434769471: Hold'em No Limit ($0.02/$0.05) - 2017/03/09 23:29:16
Table '#952' 6-max Seat #2 is the button
Seat 1: UTGplus2 ($5.81 in chips)
Seat 2: Dealer ($1.87 in chips)
Seat 3: Small Blind ($16.20 in chips)
Seat 4: Hero ($9.60 in chips)
Seat 5: UTG ($4.95 in chips)
Seat 6: UTGplus1 ($2.83 in chips)
Small Blind: posts small blind $0.02
Hero: posts big blind $0.05
*** HOLE CARDS ***
Dealt to Hero [8d 8s]
UTG: folds
UTGplus1: folds
UTGplus2: raises $0.15 to $0.15
Dealer: folds
Small Blind: folds
Hero: calls $0.10 
*** FLOP *** [7c Qd 4c]
Hero: checks
UTGplus2: bets $0.22 
Hero: calls $0.22 
*** TURN *** [7c Qd 4c] [Ah]
Hero: checks
UTGplus2: bets $0.53 
Hero: calls $0.53 
*** RIVER *** [7c Qd 4c Ah] [Qs]
Hero: bets $0.96 
UTGplus2: calls $0.96 
*** SHOW DOWN ***
Hero: shows [8d 8s] (two pair, Queens and Aces)
UTGplus2: shows [Ac Tc] (two pair, Aces and Tens)
UTGplus2 collected $3.56 from pot
*** SUMMARY ***
Total pot $3.74 | Rake $0.18
Board [7c Qd 4c Ah Qs]
Seat 1: UTGplus2 showed [Ac Tc] and won ($3.56) with two pair, Aces and Tens
Seat 2: Dealer (button) showed
Seat 3: Small Blind (small blind) showed
Seat 4: Hero (big blind) showed [8d 8s] and lost with two pair, Queens and Aces
Seat 5: UTG showed
Seat 6: UTGplus1 showed



PokerStars Zoom Hand #3434769948: Hold'em No Limit ($0.02/$0.05) - 2017/03/09 23:30:19
Table '#952' 6-max Seat #6 is the button
Seat 1: Small Blind ($2.66 in chips)
Seat 2: Big Blind ($7.14 in chips)
Seat 3: UTG ($11.07 in chips)
Seat 4: UTGplus1 ($5.61 in chips)
Seat 5: UTGplus2 ($7.51 in chips)
Seat 6: Hero ($7.74 in chips)
Small Blind: posts small blind $0.02
Big Blind: posts big blind $0.05
*** HOLE CARDS ***
Dealt to Hero [8d 9s]
UTG: folds
UTGplus1: folds
UTGplus2: folds
Hero: folds
Small Blind: calls $0.03 
Big Blind: checks
*** FLOP *** [9c 2h Ah]
Small Blind: bets $0.10 
Big Blind: calls $0.10 
*** TURN *** [9c 2h Ah] [7c]
Small Blind: bets $0.20 
Big Blind: raises $0.55 to $0.55
Small Blind: calls $0.35 
*** RIVER *** [9c 2h Ah 7c] [Ks]
Small Blind: checks
Big Blind: bets $0.70 
Small Blind: calls $0.70 
*** SHOW DOWN ***
Big Blind: shows [8h 4h] (high card Ace)
Small Blind: shows [Kc 9h] (two pair, Kings and Aces)
Small Blind collected $2.66 from pot
*** SUMMARY ***
Total pot $2.8 | Rake $0.14
Board [9c 2h Ah 7c Ks]
Seat 1: Small Blind (small blind) showed [Kc 9h] and won ($2.66) with two pair, Kings and Aces
Seat 2: Big Blind (big blind) showed [8h 4h-Ah Ks 9c 8h 7c] and lost with high card Eight
Seat 3: UTG showed
Seat 4: UTGplus1 showed
Seat 5: UTGplus2 showed
Seat 6: Hero (button) showed



PokerStars Zoom Hand #3434770091: Hold'em No Limit ($0.02/$0.05) - 2017/03/09 23:30:36
Table '#952' 6-max Seat #6 is the button
Seat 1: Small Blind ($5.02 in chips)
Seat 2: Big Blind ($19.40 in chips)
Seat 3: UTG ($11.07 in chips)
Seat 4: Hero ($7.74 in chips)
Seat 5: UTGplus2 ($9.76 in chips)
Seat 6: Dealer ($5.59 in chips)
Small Blind: posts small blind $0.02
Big Blind: posts big blind $0.05
*** HOLE CARDS ***
Dealt to Hero [Kh 4h]
UTG: folds
Hero: folds
UTGplus2: folds
Dealer: raises $0.17 to $0.17
Small Blind: folds
Big Blind: calls $0.12 
*** FLOP *** [Jc 7d 9s]
Big Blind: checks
Dealer: bets $0.25 
Big Blind: folds
Uncalled bet ($0.25) returned to Dealer
Dealer: doesn't show hand
Dealer collected $0.35 from pot
*** SUMMARY ***
Total pot $0.36 | Rake $0.01
Board [Jc 7d 9s]
Seat 1: Small Blind (small blind) showed
Seat 2: Big Blind (big blind) showed
Seat 3: UTG showed
Seat 4: Hero showed
Seat 5: UTGplus2 showed
Seat 6: Dealer (button) won ($0.35)



PokerStars Zoom Hand #3434770173: Hold'em No Limit ($0.02/$0.05) - 2017/03/09 23:30:48
Table '#952' 6-max Seat #1 is the button
Seat 1: Hero ($7.74 in chips)
Seat 2: Small Blind ($4.65 in chips)
Seat 3: Big Blind ($5 in chips)
Seat 4: UTG ($2.03 in chips)
Seat 5: UTGplus1 ($10.29 in chips)
Seat 6: UTGplus2 ($11.25 in chips)
Small Blind: posts small blind $0.02
Big Blind: posts big blind $0.05
*** HOLE CARDS ***
Dealt to Hero [2h 3c]
UTG: folds
UTGplus1: folds
UTGplus2: raises $0.11 to $0.11
Hero: folds
Small Blind: folds
Big Blind: calls $0.06 
*** FLOP *** [2s 8h Th]
Big Blind: checks
UTGplus2: checks
*** TURN *** [2s 8h Th] [Td]
Big Blind: bets $0.15 
UTGplus2: folds
Uncalled bet ($0.15) returned to Big Blind
Big Blind: doesn't show hand
Big Blind collected $0.23 from pot
Seat re-join
Table deposit $5 
*** SUMMARY ***
Total pot $0.24 | Rake $0.01
Board [2s 8h Th Td]
Seat 1: Hero (button) showed
Seat 2: Small Blind (small blind) showed
Seat 3: Big Blind (big blind) won ($0.23)
Seat 4: UTG showed
Seat 5: UTGplus1 showed
Seat 6: UTGplus2 showed



PokerStars Zoom Hand #3434770198: Hold'em No Limit ($0.02/$0.05) - 2017/03/09 23:30:52
Table '#952' 6-max Seat #3 is the button
Seat 1: UTGplus1 ($4.77 in chips)
Seat 2: UTGplus2 ($1.61 in chips)
Seat 3: Dealer ($5.65 in chips)
Seat 4: Small Blind ($9.70 in chips)
Seat 5: Hero ($7.74 in chips)
Seat 6: UTG ($5.71 in chips)
Small Blind: posts small blind $0.02
Hero: posts big blind $0.05
*** HOLE CARDS ***
Dealt to Hero [5h Js]
UTG: folds
UTGplus1: raises $0.15 to $0.15
UTGplus2: folds
Dealer: folds
Small Blind: calls $0.13 
Hero: folds
*** FLOP *** [7c 6s 9h]
Small Blind: checks
UTGplus1: checks
*** TURN *** [7c 6s 9h] [6c]
Small Blind: checks
UTGplus1: checks
*** RIVER *** [7c 6s 9h 6c] [Kh]
Small Blind: checks
UTGplus1: bets $0.15 
Small Blind: folds
Uncalled bet ($0.15) returned to UTGplus1
UTGplus1: doesn't show hand
UTGplus1 collected $0.34 from pot
*** SUMMARY ***
Total pot $0.35 | Rake $0.01
Board [7c 6s 9h 6c Kh]
Seat 1: UTGplus1 won ($0.34)
Seat 2: UTGplus2 showed
Seat 3: Dealer (button) showed
Seat 4: Small Blind (small blind) showed
Seat 5: Hero (big blind) showed
Seat 6: UTG showed



PokerStars Zoom Hand #3434770234: Hold'em No Limit ($0.02/$0.05) - 2017/03/09 23:30:57
Table '#952' 6-max Seat #5 is the button
Seat 1: Big Blind ($1.61 in chips)
Seat 2: UTG ($3.71 in chips)
Seat 3: UTGplus1 ($5.65 in chips)
Seat 4: UTGplus2 ($8.25 in chips)
Seat 5: Hero ($7.69 in chips)
Seat 6: Small Blind ($2.01 in chips)
Small Blind: posts small blind $0.02
Big Blind: posts big blind $0.05
*** HOLE CARDS ***
Dealt to Hero [5h 6s]
UTG: folds
UTGplus1: calls $0.05 
UTGplus2: folds
Hero: folds
Small Blind: calls $0.03 
Big Blind: checks
*** FLOP *** [Qc 9s Js]
Small Blind: checks
Big Blind: checks
UTGplus1: checks
*** TURN *** [Qc 9s Js] [6h]
Small Blind: checks 
Big Blind: checks
UTGplus1: bets $0.05 
Small Blind: folds
Big Blind: folds
Uncalled bet ($0.05) returned to UTGplus1
UTGplus1: doesn't show hand
UTGplus1 collected $0.15 from pot
Table deposit $0.14 
*** SUMMARY ***
Total pot $0.15 | Rake $0.00
Board [Qc 9s Js 6h]
Seat 1: Big Blind (big blind) showed
Seat 2: UTG showed
Seat 3: UTGplus1 won ($0.15)
Seat 4: UTGplus2 showed
Seat 5: Hero (button) showed
Seat 6: Small Blind (small blind) showed



PokerStars Zoom Hand #3434770270: Hold'em No Limit ($0.02/$0.05) - 2017/03/09 23:31:02
Table '#952' 6-max Seat #5 is the button
Seat 1: Big Blind ($3.71 in chips)
Seat 2: Hero ($7.69 in chips)
Seat 3: UTGplus1 ($5.18 in chips)
Seat 4: UTGplus2 ($4.59 in chips)
Seat 5: Dealer ($7.49 in chips)
Seat 6: Small Blind ($8.25 in chips)
Small Blind: posts small blind $0.02
Big Blind: posts big blind $0.05
*** HOLE CARDS ***
Dealt to Hero [9s 7c]
Hero: folds
UTGplus1: folds
UTGplus2: folds
Dealer: raises $0.15 to $0.15
Small Blind: folds
Big Blind: folds
Uncalled bet ($0.10) returned to Dealer
Dealer: doesn't show hand
Dealer collected $0.12 from pot
*** SUMMARY ***
Total pot $0.12 | Rake $0.00
Seat 1: Big Blind (big blind) showed
Seat 2: Hero showed
Seat 3: UTGplus1 showed
Seat 4: UTGplus2 showed
Seat 5: Dealer (button) won ($0.12)
Seat 6: Small Blind (small blind) showed



PokerStars Zoom Hand #3434770327: Hold'em No Limit ($0.02/$0.05) - 2017/03/09 23:31:08
Table '#952' 6-max Seat #6 is the button
Seat 1: Small Blind ($5.02 in chips)
Seat 2: Hero ($7.69 in chips)
Seat 3: UTG ($1.52 in chips)
Seat 4: UTGplus1 ($13.41 in chips)
Seat 5: UTGplus2 ($7.68 in chips)
Seat 6: Dealer ($5.93 in chips)
Small Blind: posts small blind $0.02
Hero: posts big blind $0.05
*** HOLE CARDS ***
Dealt to Hero [8c 5d]
UTG: folds
UTGplus1: folds
UTGplus2: folds
Dealer: folds
Small Blind: folds
*** SHOW DOWN ***
Hero: shows [8c 5d] (high card Eight)
Hero collected $0.07 from pot
*** SUMMARY ***
Total pot $0.07 | Rake $0.00
Seat 1: Small Blind (small blind) showed
Seat 2: Hero (big blind) collected $0.02
Seat 3: UTG showed
Seat 4: UTGplus1 showed
Seat 5: UTGplus2 showed
Seat 6: Dealer (button) showed



PokerStars Zoom Hand #3434770364: Hold'em No Limit ($0.02/$0.05) - 2017/03/09 23:31:13
Table '#952' 6-max Seat #2 is the button
Seat 1: UTGplus2 ($5 in chips)
Seat 2: Dealer ($13.41 in chips)
Seat 3: Hero ($7.64 in chips)
Seat 4: Big Blind ($5.93 in chips)
Seat 5: UTG ($7.68 in chips)
Seat 6: UTGplus1 ($1.52 in chips)
Hero: posts small blind $0.02
Big Blind: posts big blind $0.05
*** HOLE CARDS ***
Dealt to Hero [7h Jd]
UTG: folds
UTGplus1: folds
UTGplus2: folds
Dealer: folds
Hero: folds
Big Blind: doesn't show hand
Big Blind collected $0.07 from pot
*** SUMMARY ***
Total pot $0.07 | Rake $0.00
Seat 1: UTGplus2 showed
Seat 2: Dealer (button) showed
Seat 3: Hero (small blind) showed
Seat 4: Big Blind (big blind) won ($0.07)
Seat 5: UTG showed
Seat 6: UTGplus1 showed



PokerStars Zoom Hand #3434770416: Hold'em No Limit ($0.02/$0.05) - 2017/03/09 23:31:21
Table '#952' 6-max Seat #2 is the button
Seat 1: UTGplus2 ($4.79 in chips)
Seat 2: Dealer ($4.59 in chips)
Seat 3: Hero ($7.69 in chips)
Seat 4: Big Blind ($9.52 in chips)
Seat 5: UTG ($2.43 in chips)
Seat 6: UTGplus1 ($7.56 in chips)
Hero: posts small blind $0.02
Big Blind: posts big blind $0.05
*** HOLE CARDS ***
Dealt to Hero [Jc 8d]
UTG: calls $0.05 
UTGplus1: folds
UTGplus2: raises $0.22 to $0.22
Dealer: folds
Hero: folds
Big Blind: folds
UTG: calls $0.17 
*** FLOP *** [3h Tc 4d]
UTG: bets $0.05 
UTGplus2: calls $0.05 
*** TURN *** [3h Tc 4d] [Kh]
UTG: checks
UTGplus2: checks
*** RIVER *** [3h Tc 4d Kh] [8h]
UTG: checks
UTGplus2: bets $0.35 
UTG: folds
Uncalled bet ($0.35) returned to UTGplus2
UTGplus2: doesn't show hand
UTGplus2 collected $0.58 from pot
*** SUMMARY ***
Total pot $0.61 | Rake $0.03
Board [3h Tc 4d Kh 8h]
Seat 1: UTGplus2 won ($0.58)
Seat 2: Dealer (button) showed
Seat 3: Hero (small blind) showed
Seat 4: Big Blind (big blind) showed
Seat 5: UTG showed
Seat 6: UTGplus1 showed



PokerStars Zoom Hand #3434770466: Hold'em No Limit ($0.02/$0.05) - 2017/03/09 23:31:27
Table '#952' 6-max Seat #5 is the button
Seat 1: Big Blind ($5.16 in chips)
Seat 2: Hero ($7.67 in chips)
Seat 3: UTGplus1 ($3.08 in chips)
Seat 4: UTGplus2 ($8.41 in chips)
Seat 5: Dealer ($8.13 in chips)
Seat 6: Small Blind ($5.42 in chips)
Small Blind: posts small blind $0.02
Big Blind: posts big blind $0.05
*** HOLE CARDS ***
Dealt to Hero [2s 6s]
Hero: folds
UTGplus1: folds
UTGplus2: folds
Dealer: raises $0.12 to $0.12
Small Blind: folds
Big Blind: raises $0.14 to $0.19
Dealer: calls $0.07 
*** FLOP *** [Ts 9h As]
Big Blind: bets $0.05 
Dealer: calls $0.05 
*** TURN *** [Ts 9h As] [6h]
Big Blind: bets $0.25 
Dealer: calls $0.25 
*** RIVER *** [Ts 9h As 6h] [Jh]
Big Blind: bets $1 
Dealer: folds
Uncalled bet ($1) returned to Big Blind
Big Blind: doesn't show hand
Big Blind collected $0.95 from pot
Table deposit $5 
*** SUMMARY ***
Total pot $1 | Rake $0.05
Board [Ts 9h As 6h Jh]
Seat 1: Big Blind (big blind) won ($0.95)
Seat 2: Hero showed
Seat 3: UTGplus1 showed
Seat 4: UTGplus2 showed
Seat 5: Dealer (button) showed
Seat 6: Small Blind (small blind) showed



PokerStars Zoom Hand #3434770501: Hold'em No Limit ($0.02/$0.05) - 2017/03/09 23:31:33
Table '#952' 6-max Seat #3 is the button
Seat 1: UTGplus1 ($10.31 in chips)
Seat 2: Hero ($7.67 in chips)
Seat 3: Dealer ($4.51 in chips)
Seat 4: Small Blind ($9.55 in chips)
Seat 5: Big Blind ($18.96 in chips)
Seat 6: UTG ($5.74 in chips)
Small Blind: posts small blind $0.02
Big Blind: posts big blind $0.05
*** HOLE CARDS ***
Dealt to Hero [Ah 9d]
UTG: raises $0.15 to $0.15
UTGplus1: folds
Hero: folds
Dealer: folds
Small Blind: folds
Big Blind: calls $0.10 
*** FLOP *** [6s Qs Th]
Big Blind: checks
UTG: checks
*** TURN *** [6s Qs Th] [4s]
Big Blind: bets $0.16 
UTG: calls $0.16 
*** RIVER *** [6s Qs Th 4s] [3c]
Big Blind: bets $0.32 
UTG: calls $0.32 
*** SHOW DOWN ***
Big Blind: shows [Ts Qh] (two pair, Queens and Sixs)
UTG: shows [Td Ac] (One pair)
Big Blind collected $1.22 from pot
*** SUMMARY ***
Total pot $1.28 | Rake $0.06
Board [6s Qs Th 4s 3c]
Seat 1: UTGplus1 showed
Seat 2: Hero showed
Seat 3: Dealer (button) showed
Seat 4: Small Blind (small blind) showed
Seat 5: Big Blind (big blind) showed [Ts Qh] and won ($1.22) with two pair, Queens and Sixes
Seat 6: UTG showed [Td Ac]



PokerStars Zoom Hand #3434770577: Hold'em No Limit ($0.02/$0.05) - 2017/03/09 23:31:43
Table '#952' 6-max Seat #5 is the button
Seat 1: Hero ($7.67 in chips)
Seat 2: UTG ($5.75 in chips)
Seat 3: UTGplus1 ($13.75 in chips)
Seat 4: UTGplus2 ($10.31 in chips)
Seat 5: Dealer ($6.43 in chips)
Seat 6: Small Blind ($5.56 in chips)
Small Blind: posts small blind $0.02
Hero: posts big blind $0.05
*** HOLE CARDS ***
Dealt to Hero [Kh 6h]
UTG: calls $0.05 
UTGplus1: raises $0.10 to $0.10
UTGplus2: folds
Dealer: folds
Small Blind: calls $0.08 
Hero: calls $0.05 
UTG: calls $0.05 
*** FLOP *** [6d 7c Ks]
Small Blind: checks
Hero: checks
UTG: checks
UTGplus1: checks
*** TURN *** [6d 7c Ks] [2c]
Small Blind: bets $0.26 
Hero: calls $0.26 
UTG: folds
UTGplus1: folds
*** RIVER *** [6d 7c Ks 2c] [6s]
Small Blind: checks
Hero: bets $0.72 
Small Blind: calls $0.72 
*** SHOW DOWN ***
Hero: shows [Kh 6h] (a full house, Sixs full of Kings)
Small Blind: shows [Jc Kc] (Two pair)
Hero collected $2.25 from pot
*** SUMMARY ***
Total pot $2.36 | Rake $0.11
Board [6d 7c Ks 2c 6s]
Seat 1: Hero (big blind) showed [Kh 6h] and won ($2.25) with a full house, Sixes full of Kings
Seat 2: UTG showed
Seat 3: UTGplus1 showed
Seat 4: UTGplus2 showed
Seat 5: Dealer (button) showed
Seat 6: Small Blind (small blind) showed [Jc Kc]



PokerStars Zoom Hand #3434771247: Hold'em No Limit ($0.02/$0.05) - 2017/03/09 23:33:14
Table '#952' 6-max Seat #3 is the button
Seat 1: UTGplus1 ($5.08 in chips)
Seat 2: UTGplus2 ($6.12 in chips)
Seat 3: Hero ($8.84 in chips)
Seat 4: Small Blind ($4.48 in chips)
Seat 5: Big Blind ($5.73 in chips)
Seat 6: UTG ($6.57 in chips)
Small Blind: posts small blind $0.02
Big Blind: posts big blind $0.05
*** HOLE CARDS ***
Dealt to Hero [Jd Jh]
UTG: folds
UTGplus1: folds
UTGplus2: folds
Hero: raises $0.17 to $0.17
Small Blind: folds
Big Blind: folds
Uncalled bet ($0.12) returned to Hero
Hero: doesn't show hand
Hero collected $0.12 from pot
Seat re-join
Table deposit $5 
*** SUMMARY ***
Total pot $0.12 | Rake $0.00
Seat 1: UTGplus1 showed
Seat 2: UTGplus2 showed
Seat 3: Hero (button) won ($0.12)
Seat 4: Small Blind (small blind) showed
Seat 5: Big Blind (big blind) showed
Seat 6: UTG showed



PokerStars Zoom Hand #3434771523: Hold'em No Limit ($0.02/$0.05) - 2017/03/09 23:33:50
Table '#952' 6-max Seat #5 is the button
Seat 1: Big Blind ($4.95 in chips)
Seat 2: Hero ($8.91 in chips)
Seat 3: UTGplus1 ($17.36 in chips)
Seat 4: UTGplus2 ($10.13 in chips)
Seat 5: Dealer ($4.59 in chips)
Seat 6: Small Blind ($4.33 in chips)
Small Blind: posts small blind $0.02
Big Blind: posts big blind $0.05
*** HOLE CARDS ***
Dealt to Hero [3s 7c]
Hero: folds 
UTGplus1: folds
UTGplus2: folds
Dealer: folds
Small Blind: raises $0.13 to $0.15
Big Blind: folds
Uncalled bet ($0.10) returned to Small Blind
Small Blind: doesn't show hand
Small Blind collected $0.1 from pot
*** SUMMARY ***
Total pot $0.1 | Rake $0.00
Seat 1: Big Blind (big blind) showed
Seat 2: Hero showed
Seat 3: UTGplus1 showed
Seat 4: UTGplus2 showed
Seat 5: Dealer (button) showed
Seat 6: Small Blind (small blind) won ($0.1)



PokerStars Zoom Hand #3434771902: Hold'em No Limit ($0.02/$0.05) - 2017/03/09 23:34:40
Table '#952' 6-max Seat #2 is the button
Seat 1: Hero ($8.91 in chips)
Seat 2: Dealer ($13.53 in chips)
Seat 3: Small Blind ($5.02 in chips)
Seat 4: Big Blind ($9.67 in chips)
Seat 5: UTG ($9.24 in chips)
Seat 6: UTGplus1 ($5.02 in chips)
Small Blind: posts small blind $0.02
Big Blind: posts big blind $0.05
*** HOLE CARDS ***
Dealt to Hero [Kd 8d]
UTG: folds
UTGplus1: folds
Hero: folds
Dealer: raises $0.15 to $0.15
Small Blind: folds
Big Blind: folds
Uncalled bet ($0.10) returned to Dealer
Dealer: doesn't show hand
Dealer collected $0.12 from pot
*** SUMMARY ***
Total pot $0.12 | Rake $0.00
Seat 1: Hero showed
Seat 2: Dealer (button) won ($0.12)
Seat 3: Small Blind (small blind) showed
Seat 4: Big Blind (big blind) showed
Seat 5: UTG showed
Seat 6: UTGplus1 showed



PokerStars Zoom Hand #3434771984: Hold'em No Limit ($0.02/$0.05) - 2017/03/09 23:34:51
Table '#952' 6-max Seat #1 is the button
Seat 1: Dealer ($4.92 in chips)
Seat 2: Hero ($8.91 in chips)
Seat 3: Big Blind ($8.21 in chips)
Seat 4: UTG ($5.65 in chips)
Seat 5: UTGplus1 ($6.88 in chips)
Seat 6: UTGplus2 ($5 in chips)
Hero: posts small blind $0.02
Big Blind: posts big blind $0.05
*** HOLE CARDS ***
Dealt to Hero [Ts 9h]
UTG: raises $0.15 to $0.15
UTGplus1: folds
UTGplus2: folds
Dealer: calls $0.15 
Hero: folds
Big Blind: calls $0.10 
*** FLOP *** [8d 6d 2c]
Big Blind: checks
UTG: bets $0.20 
Dealer: folds
Big Blind: calls $0.20 
*** TURN *** [8d 6d 2c] [7d]
Big Blind: checks
UTG: checks
*** RIVER *** [8d 6d 2c 7d] [Kd]
Big Blind: bets $0.23 
UTG: calls $0.23 
*** SHOW DOWN ***
Big Blind: shows [3h 3d] (a flush, King high)
UTG: shows [6c 6h] (Three of a kind)
Big Blind collected $1.27 from pot
*** SUMMARY ***
Total pot $1.33 | Rake $0.06
Board [8d 6d 2c 7d Kd]
Seat 1: Dealer (button) showed
Seat 2: Hero (small blind) showed
Seat 3: Big Blind (big blind) showed [3h 3d] and won ($1.27) with a flush, King high
Seat 4: UTG showed [6c 6h]
Seat 5: UTGplus1 showed
Seat 6: UTGplus2 showed



PokerStars Zoom Hand #3434772046: Hold'em No Limit ($0.02/$0.05) - 2017/03/09 23:35:01
Table '#952' 6-max Seat #2 is the button
Seat 1: Hero ($8.89 in chips)
Seat 2: Dealer ($4.63 in chips)
Seat 3: Small Blind ($4.93 in chips)
Seat 4: Big Blind ($4.99 in chips)
Seat 5: UTG ($1.16 in chips)
Seat 6: UTGplus1 ($5.99 in chips)
Small Blind: posts small blind $0.02
Big Blind: posts big blind $0.05
*** HOLE CARDS ***
Dealt to Hero [Js Ad]
UTG: folds
UTGplus1: folds
Hero: raises $0.15 to $0.15
Dealer: folds
Small Blind: folds
Big Blind: folds
Uncalled bet ($0.10) returned to Hero
Hero: doesn't show hand
Hero collected $0.12 from pot
Seat re-join
*** SUMMARY ***
Total pot $0.12 | Rake $0.00
Seat 1: Hero won ($0.12)
Seat 2: Dealer (button) showed
Seat 3: Small Blind (small blind) showed
Seat 4: Big Blind (big blind) showed
Seat 5: UTG showed
Seat 6: UTGplus1 showed



PokerStars Zoom Hand #3434772220: Hold'em No Limit ($0.02/$0.05) - 2017/03/09 23:35:26
Table '#952' 6-max Seat #3 is the button
Seat 1: UTGplus1 ($10.15 in chips)
Seat 2: UTGplus2 ($4.60 in chips)
Seat 3: Dealer ($10.36 in chips)
Seat 4: Small Blind ($4.88 in chips)
Seat 5: Hero ($8.96 in chips)
Seat 6: UTG ($11.51 in chips)
Small Blind: posts small blind $0.02
Hero: posts big blind $0.05
*** HOLE CARDS ***
Dealt to Hero [Qh Kc]
UTG: folds
UTGplus1: raises $0.15 to $0.15
UTGplus2: calls $0.15 
Dealer: calls $0.15 
Small Blind: folds
Hero: raises $0.62 to $0.67
UTGplus1: folds
UTGplus2: folds
Dealer: folds
Uncalled bet ($0.52) returned to Hero
Hero: doesn't show hand
Hero collected $0.62 from pot
*** SUMMARY ***
Total pot $0.62 | Rake $0.00
Seat 1: UTGplus1 showed
Seat 2: UTGplus2 showed
Seat 3: Dealer (button) showed
Seat 4: Small Blind (small blind) showed
Seat 5: Hero (big blind) won ($0.62)
Seat 6: UTG showed



PokerStars Zoom Hand #3434772549: Hold'em No Limit ($0.02/$0.05) - 2017/03/09 23:36:11
Table '#952' 6-max Seat #2 is the button
Seat 1: UTGplus2 ($4.80 in chips)
Seat 2: Hero ($9.43 in chips)
Seat 3: Small Blind ($16.03 in chips)
Seat 4: Big Blind ($5.05 in chips)
Seat 5: UTG ($2.60 in chips)
Seat 6: UTGplus1 ($8.94 in chips)
Small Blind: posts small blind $0.02
Big Blind: posts big blind $0.05
*** HOLE CARDS ***
Dealt to Hero [3c Js]
UTG: raises $0.10 to $0.10
UTGplus1: folds
UTGplus2: folds
Hero: folds
Small Blind: calls $0.08 
Big Blind: calls $0.05 
*** FLOP *** [6s 5c Ah]
Small Blind: checks
Big Blind: checks
UTG: bets $0.09 
Small Blind: calls $0.09 
Big Blind: folds
*** TURN *** [6s 5c Ah] [2d]
Small Blind: checks
UTG: bets $0.14 
Small Blind: calls $0.14 
*** RIVER *** [6s 5c Ah 2d] [8h]
Small Blind: bets $0.76 
UTG: calls $0.76 
*** SHOW DOWN ***
Small Blind: shows [7c 9c] (a straight, Five to Nine)
UTG: shows [Ac Th] (One pair)
Small Blind collected $2.17 from pot
Table leave user
*** SUMMARY ***
Total pot $2.28 | Rake $0.11
Board [6s 5c Ah 2d 8h]
Seat 1: UTGplus2 showed
Seat 2: Hero (button) showed
Seat 3: Small Blind (small blind) showed [7c 9c] and won ($2.17) with a straight, Five to Nine
Seat 4: Big Blind (big blind) showed
Seat 5: UTG showed [Ac Th]
Seat 6: UTGplus1 showed



PokerStars Zoom Hand #3434772613: Hold'em No Limit ($0.02/$0.05) - 2017/03/09 23:36:22
Table '#952' 6-max Seat #5 is the button
Seat 1: Big Blind ($8.13 in chips)
Seat 2: UTG ($4.10 in chips)
Seat 3: UTGplus1 ($4.47 in chips)
Seat 4: UTGplus2 ($5.67 in chips)
Seat 5: Dealer ($4.80 in chips)
Seat 6: Hero ($9.43 in chips)
Hero: posts small blind $0.02
Big Blind: posts big blind $0.05
*** HOLE CARDS ***
Dealt to Hero [2d Kc]
UTG: raises $0.10 to $0.10
UTGplus1: folds
UTGplus2: folds
Dealer: folds
Hero: folds
Big Blind: calls $0.05 
*** FLOP *** [Jd 7d 2s]
Big Blind: checks
UTG: checks
*** TURN *** [Jd 7d 2s] [Jh]
Big Blind: checks
UTG: checks
*** RIVER *** [Jd 7d 2s Jh] [Ad]
Big Blind: checks
UTG: bets $0.11 
Big Blind: folds
Uncalled bet ($0.11) returned to UTG
UTG: doesn't show hand
UTG collected $0.21 from pot
Table deposit $5 
*** SUMMARY ***
Total pot $0.22 | Rake $0.01
Board [Jd 7d 2s Jh Ad]
Seat 1: Big Blind (big blind) showed
Seat 2: UTG won ($0.21)
Seat 3: UTGplus1 showed
Seat 4: UTGplus2 showed
Seat 5: Dealer (button) showed
Seat 6: Hero (small blind) showed



PokerStars Zoom Hand #3434772652: Hold'em No Limit ($0.02/$0.05) - 2017/03/09 23:36:28
Table '#952' 6-max Seat #2 is the button
Seat 1: UTGplus2 ($4.80 in chips)
Seat 2: Dealer ($6.28 in chips)
Seat 3: Hero ($9.41 in chips)
Seat 4: Big Blind ($5 in chips)
Seat 5: UTG ($9.56 in chips)
Seat 6: UTGplus1 ($12.49 in chips)
Hero: posts small blind $0.02
Big Blind: posts big blind $0.05
*** HOLE CARDS ***
Dealt to Hero [Tc 4s]
UTG: folds
UTGplus1: folds
UTGplus2: folds
Dealer: folds
Hero: folds
Big Blind: doesn't show hand
Big Blind collected $0.07 from pot
*** SUMMARY ***
Total pot $0.07 | Rake $0.00
Seat 1: UTGplus2 showed
Seat 2: Dealer (button) showed
Seat 3: Hero (small blind) showed
Seat 4: Big Blind (big blind) won ($0.07)
Seat 5: UTG showed
Seat 6: UTGplus1 showed



PokerStars Zoom Hand #3434772681: Hold'em No Limit ($0.02/$0.05) - 2017/03/09 23:36:32
Table '#952' 6-max Seat #2 is the button
Seat 1: UTGplus2 ($9.56 in chips)
Seat 2: Dealer ($6.28 in chips)
Seat 3: Small Blind ($4.80 in chips)
Seat 4: Big Blind ($13.39 in chips)
Seat 5: UTG ($4.95 in chips)
Seat 6: Hero ($9.39 in chips)
Small Blind: posts small blind $0.02
Big Blind: posts big blind $0.05
*** HOLE CARDS ***
Dealt to Hero [Jd Qh]
UTG: folds
Hero: raises $0.17 to $0.17
UTGplus2: folds
Dealer: folds
Small Blind: folds
Big Blind: folds
Uncalled bet ($0.12) returned to Hero
Hero: doesn't show hand
Hero collected $0.12 from pot
*** SUMMARY ***
Total pot $0.12 | Rake $0.00
Seat 1: UTGplus2 showed
Seat 2: Dealer (button) showed
Seat 3: Small Blind (small blind) showed
Seat 4: Big Blind (big blind) showed
Seat 5: UTG showed
Seat 6: Hero won ($0.12)



PokerStars Zoom Hand #3434772866: Hold'em No Limit ($0.02/$0.05) - 2017/03/09 23:36:55
Table '#952' 6-max Seat #1 is the button
Seat 1: Dealer ($4.93 in chips)
Seat 2: Small Blind ($8.03 in chips)
Seat 3: Big Blind ($12.72 in chips)
Seat 4: UTG ($4.21 in chips)
Seat 5: Hero ($9.46 in chips)
Seat 6: UTGplus2 ($6.04 in chips)
Small Blind: posts small blind $0.02
Big Blind: posts big blind $0.05
*** HOLE CARDS ***
Dealt to Hero [7s 9c]
UTG: folds
Hero: folds
UTGplus2: folds
Dealer: folds
Small Blind: raises $0.13 to $0.15
Big Blind: folds
Uncalled bet ($0.10) returned to Small Blind
Small Blind: doesn't show hand
Small Blind collected $0.1 from pot
Seat re-join
*** SUMMARY ***
Total pot $0.1 | Rake $0.00
Seat 1: Dealer (button) showed
Seat 2: Small Blind (small blind) won ($0.1)
Seat 3: Big Blind (big blind) showed
Seat 4: UTG showed
Seat 5: Hero showed
Seat 6: UTGplus2 showed



PokerStars Zoom Hand #3434772900: Hold'em No Limit ($0.02/$0.05) - 2017/03/09 23:37:01
Table '#952' 6-max Seat #6 is the button
Seat 1: Small Blind ($17.11 in chips)
Seat 2: Big Blind ($1.51 in chips)
Seat 3: UTG ($6.21 in chips)
Seat 4: Hero ($9.46 in chips)
Seat 5: UTGplus2 ($4.21 in chips)
Seat 6: Dealer ($13.54 in chips)
Small Blind: posts small blind $0.02
Big Blind: posts big blind $0.05
*** HOLE CARDS ***
Dealt to Hero [5s 4d]
UTG: folds
Hero: folds
UTGplus2: folds
Dealer: folds
Small Blind: folds
Big Blind: doesn't show hand
Big Blind collected $0.07 from pot
*** SUMMARY ***
Total pot $0.07 | Rake $0.00
Seat 1: Small Blind (small blind) showed
Seat 2: Big Blind (big blind) won ($0.07)
Seat 3: UTG showed
Seat 4: Hero showed
Seat 5: UTGplus2 showed
Seat 6: Dealer (button) showed



PokerStars Zoom Hand #3434772961: Hold'em No Limit ($0.02/$0.05) - 2017/03/09 23:37:08
Table '#952' 6-max Seat #5 is the button
Seat 1: Hero ($9.46 in chips)
Seat 2: UTG ($6.42 in chips)
Seat 3: UTGplus1 ($4.21 in chips)
Seat 4: UTGplus2 ($3.30 in chips)
Seat 5: Dealer ($3.91 in chips)
Seat 6: Small Blind ($6.01 in chips)
Small Blind: posts small blind $0.02
Hero: posts big blind $0.05
*** HOLE CARDS ***
Dealt to Hero [Tc Kd]
UTG: folds
UTGplus1: raises $0.10 to $0.10
UTGplus2: folds
Dealer: folds
Small Blind: raises $0.13 to $0.15
Hero: calls $0.10 
UTGplus1: calls $0.05 
*** FLOP *** [7d Kh 9d]
Small Blind: checks
Hero: bets $0.27 
UTGplus1: folds
Small Blind: folds
Uncalled bet ($0.27) returned to Hero
Hero: doesn't show hand
Hero collected $0.43 from pot
*** SUMMARY ***
Total pot $0.45 | Rake $0.02
Board [7d Kh 9d]
Seat 1: Hero (big blind) won ($0.43)
Seat 2: UTG showed
Seat 3: UTGplus1 showed
Seat 4: UTGplus2 showed
Seat 5: Dealer (button) showed
Seat 6: Small Blind (small blind) showed



PokerStars Zoom Hand #3434773281: Hold'em No Limit ($0.02/$0.05) - 2017/03/09 23:37:54
Table '#952' 6-max Seat #1 is the button
Seat 1: Hero ($9.74 in chips)
Seat 2: Small Blind ($1.36 in chips)
Seat 3: Big Blind ($4.45 in chips)
Seat 4: UTG ($4.88 in chips)
Seat 5: UTGplus1 ($5.49 in chips)
Seat 6: UTGplus2 ($6.18 in chips)
Small Blind: posts small blind $0.02
Big Blind: posts big blind $0.05
*** HOLE CARDS ***
Dealt to Hero [Ac Kc]
UTG: folds
UTGplus1: raises $0.15 to $0.15
UTGplus2: folds
Hero: raises $0.47 to $0.47
Small Blind: folds
Big Blind: folds
UTGplus1: folds
Uncalled bet ($0.32) returned to Hero
Hero: doesn't show hand
Hero collected $0.37 from pot
*** SUMMARY ***
Total pot $0.37 | Rake $0.00
Seat 1: Hero (button) won ($0.37)
Seat 2: Small Blind (small blind) showed
Seat 3: Big Blind (big blind) showed
Seat 4: UTG showed
Seat 5: UTGplus1 showed
Seat 6: UTGplus2 showed



PokerStars Zoom Hand #3434773513: Hold'em No Limit ($0.02/$0.05) - 2017/03/09 23:38:24
Table '#952' 6-max Seat #1 is the button
Seat 1: Dealer ($15.15 in chips)
Seat 2: Small Blind ($8.62 in chips)
Seat 3: Big Blind ($1.34 in chips)
Seat 4: Hero ($9.96 in chips)
Seat 5: UTGplus1 ($13.65 in chips)
Seat 6: UTGplus2 ($1.12 in chips)
Small Blind: posts small blind $0.02
Big Blind: posts big blind $0.05
*** HOLE CARDS ***
Dealt to Hero [8c 2c]
Hero: folds
UTGplus1: folds
UTGplus2: folds
Dealer: folds
Small Blind: folds
Big Blind: doesn't show hand
Big Blind collected $0.07 from pot
*** SUMMARY ***
Total pot $0.07 | Rake $0.00
Seat 1: Dealer (button) showed
Seat 2: Small Blind (small blind) showed
Seat 3: Big Blind (big blind) won ($0.07)
Seat 4: Hero showed
Seat 5: UTGplus1 showed
Seat 6: UTGplus2 showed



PokerStars Zoom Hand #3434773586: Hold'em No Limit ($0.02/$0.05) - 2017/03/09 23:38:33
Table '#952' 6-max Seat #4 is the button
Seat 1: Hero ($9.96 in chips)
Seat 2: UTGplus1 ($5.05 in chips)
Seat 3: UTGplus2 ($8.03 in chips)
Seat 4: Dealer ($4.88 in chips)
Seat 5: Small Blind ($11.37 in chips)
Seat 6: Big Blind ($4.58 in chips)
Small Blind: posts small blind $0.02
Big Blind: posts big blind $0.05
*** HOLE CARDS ***
Dealt to Hero [2c 7h]
Hero: folds
UTGplus1: folds
UTGplus2: folds
Dealer: raises $0.15 to $0.15
Small Blind: folds
Big Blind: folds
Uncalled bet ($0.10) returned to Dealer
Dealer: doesn't show hand
Dealer collected $0.12 from pot
*** SUMMARY ***
Total pot $0.12 | Rake $0.00
Seat 1: Hero showed
Seat 2: UTGplus1 showed
Seat 3: UTGplus2 showed
Seat 4: Dealer (button) won ($0.12)
Seat 5: Small Blind (small blind) showed
Seat 6: Big Blind (big blind) showed



PokerStars Zoom Hand #3434773630: Hold'em No Limit ($0.02/$0.05) - 2017/03/09 23:38:39
Table '#952' 6-max Seat #3 is the button
Seat 1: UTGplus1 ($3.17 in chips)
Seat 2: Hero ($9.96 in chips)
Seat 3: Dealer ($7.52 in chips)
Seat 4: Small Blind ($5.34 in chips)
Seat 5: Big Blind ($10.08 in chips)
Seat 6: UTG ($5 in chips)
Small Blind: posts small blind $0.02
Big Blind: posts big blind $0.05
*** HOLE CARDS ***
Dealt to Hero [Ts 4s]
UTG: raises $0.15 to $0.15
UTGplus1: folds
Hero: folds
Dealer: folds 
Small Blind: folds
Big Blind: folds
Uncalled bet ($0.10) returned to UTG
UTG: doesn't show hand
UTG collected $0.12 from pot
*** SUMMARY ***
Total pot $0.12 | Rake $0.00
Seat 1: UTGplus1 showed
Seat 2: Hero showed
Seat 3: Dealer (button) showed
Seat 4: Small Blind (small blind) showed
Seat 5: Big Blind (big blind) showed
Seat 6: UTG won ($0.12)



PokerStars Zoom Hand #3434773660: Hold'em No Limit ($0.02/$0.05) - 2017/03/09 23:38:44
Table '#952' 6-max Seat #5 is the button
Seat 1: Big Blind ($5 in chips)
Seat 2: UTG ($2.83 in chips)
Seat 3: UTGplus1 ($3.17 in chips)
Seat 4: Hero ($9.96 in chips)
Seat 5: Dealer ($3.51 in chips)
Seat 6: Small Blind ($14.08 in chips)
Small Blind: posts small blind $0.02
Big Blind: posts big blind $0.05
*** HOLE CARDS ***
Dealt to Hero [2c 7d]
UTG: raises $0.10 to $0.10
UTGplus1: folds
Hero: folds
Dealer: folds
Small Blind: folds 
Big Blind: raises $0.15 to $0.20
UTG: calls $0.10 
*** FLOP *** [3s 5s Ad]
Big Blind: checks
UTG: checks
*** TURN *** [3s 5s Ad] [5c]
Big Blind: bets $0.42 
UTG: calls $0.42 
*** RIVER *** [3s 5s Ad 5c] [Jh]
Big Blind: bets $0.63 
UTG: folds
Uncalled bet ($0.63) returned to Big Blind
Big Blind: doesn't show hand
Big Blind collected $1.2 from pot
*** SUMMARY ***
Total pot $1.26 | Rake $0.06
Board [3s 5s Ad 5c Jh]
Seat 1: Big Blind (big blind) won ($1.2)
Seat 2: UTG showed
Seat 3: UTGplus1 showed
Seat 4: Hero showed
Seat 5: Dealer (button) showed
Seat 6: Small Blind (small blind) showed



PokerStars Zoom Hand #3434773700: Hold'em No Limit ($0.02/$0.05) - 2017/03/09 23:38:49
Table '#952' 6-max Seat #4 is the button
Seat 1: UTG ($11.35 in chips)
Seat 2: UTGplus1 ($3.51 in chips)
Seat 3: UTGplus2 ($0.76 in chips)
Seat 4: Hero ($9.96 in chips)
Seat 5: Small Blind ($3.17 in chips)
Seat 6: Big Blind ($2.50 in chips)
Small Blind: posts small blind $0.02
Big Blind: posts big blind $0.05
*** HOLE CARDS ***
Dealt to Hero [9h Jd]
UTG: calls $0.05 
UTGplus1: raises $0.10 to $0.10
UTGplus2: folds
Hero: calls $0.10 
Small Blind: folds
Big Blind: folds
UTG: calls $0.05 
*** FLOP *** [2h 8h 2d]
UTG: checks
UTGplus1: bets $0.05 
Hero: calls $0.05 
UTG: calls $0.05 
*** TURN *** [2h 8h 2d] [7c]
UTG: checks
UTGplus1: bets $0.26 
Hero: folds
UTG: calls $0.26 
*** RIVER *** [2h 8h 2d 7c] [5d]
UTG: checks
UTGplus1: bets $3.10 and is all-in
UTG: calls $3.10 
*** SHOW DOWN ***
UTGplus1: shows [Js Qs] (a pair of Deuces)
UTG: shows [6c 6s] (two pair, Sixs and Eights)
UTG collected $6.88 from pot
*** SUMMARY ***
Total pot $7.24 | Rake $0.36
Board [2h 8h 2d 7c 5d]
Seat 1: UTG showed [6c 6s] and won ($6.88) with two pair, Sixes and Eights
Seat 2: UTGplus1 showed [Js Qs] and lost with a pair of Deuces
Seat 3: UTGplus2 showed
Seat 4: Hero (button) showed
Seat 5: Small Blind (small blind) showed
Seat 6: Big Blind (big blind) showed



PokerStars Zoom Hand #3434774117: Hold'em No Limit ($0.02/$0.05) - 2017/03/09 23:39:47
Table '#952' 6-max Seat #5 is the button
Seat 1: Hero ($9.81 in chips)
Seat 2: UTG ($3.07 in chips)
Seat 3: UTGplus1 ($13.26 in chips)
Seat 4: UTGplus2 ($4.95 in chips)
Seat 5: Dealer ($2.57 in chips)
Seat 6: Small Blind ($5.06 in chips)
Small Blind: posts small blind $0.02
Hero: posts big blind $0.05
*** HOLE CARDS ***
Dealt to Hero [Td 3h]
UTG: folds
UTG: Table leave user
UTGplus1: raises $0.12 to $0.12
UTGplus2: folds
Dealer: calls $0.12 
Small Blind: folds
Hero: folds
*** FLOP *** [4s Kc 7d]
UTGplus1: bets $0.15 
Dealer: folds
Uncalled bet ($0.15) returned to UTGplus1
UTGplus1: doesn't show hand
UTGplus1 collected $0.3 from pot
*** SUMMARY ***
Total pot $0.31 | Rake $0.01
Board [4s Kc 7d]
Seat 1: Hero (big blind) showed
Seat 2: UTG showed
Seat 3: UTGplus1 won ($0.3)
Seat 4: UTGplus2 showed
Seat 5: Dealer (button) showed
Seat 6: Small Blind (small blind) showed



PokerStars Zoom Hand #3434774201: Hold'em No Limit ($0.02/$0.05) - 2017/03/09 23:39:59
Table '#952' 6-max Seat #2 is the button
Seat 1: UTGplus2 ($7.68 in chips)
Seat 2: Dealer ($2.52 in chips)
Seat 3: Small Blind ($15.81 in chips)
Seat 4: Big Blind ($9.88 in chips)
Seat 5: UTG ($4.09 in chips)
Seat 6: Hero ($9.76 in chips)
Small Blind: posts small blind $0.02
Big Blind: posts big blind $0.05
*** HOLE CARDS ***
Dealt to Hero [4d 4c]
UTG: folds
Hero: raises $0.17 to $0.17
UTGplus2: folds
Dealer: folds
Small Blind: calls $0.15 
Big Blind: folds
*** FLOP *** [3h 4h 8d]
Small Blind: checks
Hero: bets $0.29 
Small Blind: folds
Uncalled bet ($0.29) returned to Hero
Hero: doesn't show hand
Hero collected $0.38 from pot
*** SUMMARY ***
Total pot $0.39 | Rake $0.01
Board [3h 4h 8d]
Seat 1: UTGplus2 showed
Seat 2: Dealer (button) showed
Seat 3: Small Blind (small blind) showed
Seat 4: Big Blind (big blind) showed
Seat 5: UTG showed
Seat 6: Hero won ($0.38)



PokerStars Zoom Hand #3434774449: Hold'em No Limit ($0.02/$0.05) - 2017/03/09 23:40:32
Table '#952' 6-max Seat #2 is the button
Seat 1: UTGplus2 ($9.83 in chips)
Seat 2: Dealer ($11.65 in chips)
Seat 3: Small Blind ($1.16 in chips)
Seat 4: Big Blind ($4.23 in chips)
Seat 5: UTG ($2.47 in chips)
Seat 6: Hero ($9.97 in chips)
Small Blind: posts small blind $0.02
Big Blind: posts big blind $0.05
*** HOLE CARDS ***
Dealt to Hero [Jh 6h]
UTG: folds
Hero: folds
UTGplus2: raises $0.15 to $0.15
Dealer: folds
Small Blind: folds
Big Blind: folds
Uncalled bet ($0.10) returned to UTGplus2
UTGplus2: doesn't show hand
UTGplus2 collected $0.12 from pot
Table leave user
*** SUMMARY ***
Total pot $0.12 | Rake $0.00
Seat 1: UTGplus2 won ($0.12)
Seat 2: Dealer (button) showed
Seat 3: Small Blind (small blind) showed
Seat 4: Big Blind (big blind) showed
Seat 5: UTG showed
Seat 6: Hero showed



PokerStars Zoom Hand #3434774501: Hold'em No Limit ($0.02/$0.05) - 2017/03/09 23:40:39
Table '#952' 6-max Seat #1 is the button
Seat 1: Dealer ($6.07 in chips)
Seat 2: Small Blind ($8.29 in chips)
Seat 3: Big Blind ($4.41 in chips)
Seat 4: Hero ($9.97 in chips)
Seat 5: UTGplus1 ($6 in chips)
Seat 6: UTGplus2 ($9.72 in chips)
Small Blind: posts small blind $0.02
Big Blind: posts big blind $0.05
*** HOLE CARDS ***
Dealt to Hero [Tc 9s]
Hero: folds
UTGplus1: folds
UTGplus2: folds
Dealer: folds
Small Blind: folds
Big Blind: doesn't show hand
Big Blind collected $0.07 from pot
Table deposit $5 
*** SUMMARY ***
Total pot $0.07 | Rake $0.00
Seat 1: Dealer (button) showed
Seat 2: Small Blind (small blind) showed
Seat 3: Big Blind (big blind) won ($0.07)
Seat 4: Hero showed
Seat 5: UTGplus1 showed
Seat 6: UTGplus2 showed



PokerStars Zoom Hand #3434774540: Hold'em No Limit ($0.02/$0.05) - 2017/03/09 23:40:45
Table '#952' 6-max Seat #1 is the button
Seat 1: Dealer ($13.60 in chips)
Seat 2: Hero ($9.97 in chips)
Seat 3: Big Blind ($7.70 in chips)
Seat 4: UTG ($4.58 in chips)
Seat 5: UTGplus1 ($1.93 in chips)
Seat 6: UTGplus2 ($10.60 in chips)
Hero: posts small blind $0.02
Big Blind: posts big blind $0.05
*** HOLE CARDS ***
Dealt to Hero [Jd 2h]
UTG: folds
UTGplus1: folds
UTGplus2: raises $0.15 to $0.15
Dealer: folds
Hero: folds
Big Blind: folds
Uncalled bet ($0.10) returned to UTGplus2
UTGplus2: doesn't show hand
UTGplus2 collected $0.12 from pot
*** SUMMARY ***
Total pot $0.12 | Rake $0.00
Seat 1: Dealer (button) showed
Seat 2: Hero (small blind) showed
Seat 3: Big Blind (big blind) showed
Seat 4: UTG showed
Seat 5: UTGplus1 showed
Seat 6: UTGplus2 won ($0.12)



PokerStars Zoom Hand #3434774586: Hold'em No Limit ($0.02/$0.05) - 2017/03/09 23:40:51
Table '#952' 6-max Seat #1 is the button
Seat 1: Hero ($9.95 in chips)
Seat 2: Small Blind ($15.34 in chips)
Seat 3: Big Blind ($9.90 in chips)
Seat 4: UTG ($4.15 in chips)
Seat 5: UTGplus1 ($8.97 in chips)
Seat 6: UTGplus2 ($6.07 in chips)
Small Blind: posts small blind $0.02
Big Blind: posts big blind $0.05
*** HOLE CARDS ***
Dealt to Hero [6h 2d]
UTG: folds
UTGplus1: folds
UTGplus2: folds
Hero: folds
Small Blind: folds
Big Blind: doesn't show hand
Big Blind collected $0.07 from pot
*** SUMMARY ***
Total pot $0.07 | Rake $0.00
Seat 1: Hero (button) showed
Seat 2: Small Blind (small blind) showed
Seat 3: Big Blind (big blind) won ($0.07)
Seat 4: UTG showed
Seat 5: UTGplus1 showed
Seat 6: UTGplus2 showed



PokerStars Zoom Hand #3434774632: Hold'em No Limit ($0.02/$0.05) - 2017/03/09 23:40:56
Table '#952' 6-max Seat #6 is the button
Seat 1: Small Blind ($13.35 in chips)
Seat 2: Big Blind ($6.07 in chips)
Seat 3: Hero ($9.95 in chips)
Seat 4: UTGplus1 ($8.97 in chips)
Seat 5: UTGplus2 ($14.67 in chips)
Seat 6: Dealer ($7.65 in chips)
Small Blind: posts small blind $0.02
Big Blind: posts big blind $0.05
*** HOLE CARDS ***
Dealt to Hero [9c 8s]
Hero: folds
UTGplus1: folds
UTGplus2: folds
Dealer: folds
Small Blind: folds
Big Blind: doesn't show hand
Big Blind collected $0.07 from pot
*** SUMMARY ***
Total pot $0.07 | Rake $0.00
Seat 1: Small Blind (small blind) showed
Seat 2: Big Blind (big blind) won ($0.07)
Seat 3: Hero showed
Seat 4: UTGplus1 showed
Seat 5: UTGplus2 showed
Seat 6: Dealer (button) showed



PokerStars Zoom Hand #3434774658: Hold'em No Limit ($0.02/$0.05) - 2017/03/09 23:41:01
Table '#952' 6-max Seat #3 is the button
Seat 1: UTGplus1 ($5.51 in chips)
Seat 2: UTGplus2 ($10.67 in chips)
Seat 3: Dealer ($5.09 in chips)
Seat 4: Small Blind ($4.97 in chips)
Seat 5: Hero ($9.95 in chips)
Seat 6: UTG ($2.74 in chips)
Small Blind: posts small blind $0.02
Hero: posts big blind $0.05
*** HOLE CARDS ***
Dealt to Hero [Td 7c]
UTG: folds
UTGplus1: folds
UTGplus2: raises $0.15 to $0.15
Dealer: calls $0.15 
Small Blind: folds
Hero: folds
*** FLOP *** [Ad 2h 9d]
UTGplus2: checks
Dealer: checks
*** TURN *** [Ad 2h 9d] [Qc]
UTGplus2: bets $0.18 
Dealer: calls $0.18 
*** RIVER *** [Ad 2h 9d Qc] [Kc]
UTGplus2: bets $0.36 
Dealer: calls $0.36 
*** SHOW DOWN ***
UTGplus2: shows [Jc 9c] (a pair of Nines)
Dealer: shows [Qs Jh] (a pair of Queens)
Dealer collected $1.38 from pot
*** SUMMARY ***
Total pot $1.45 | Rake $0.07
Board [Ad 2h 9d Qc Kc]
Seat 1: UTGplus1 showed
Seat 2: UTGplus2 showed [Jc 9c] and lost with a pair of Nines
Seat 3: Dealer (button) showed [Qs Jh] and won ($1.38) with a pair of Queens
Seat 4: Small Blind (small blind) showed
Seat 5: Hero (big blind) showed
Seat 6: UTG showed



PokerStars Zoom Hand #3434774701: Hold'em No Limit ($0.02/$0.05) - 2017/03/09 23:41:06
Table '#952' 6-max Seat #2 is the button
Seat 1: UTGplus2 ($9.92 in chips)
Seat 2: Hero ($9.90 in chips)
Seat 3: Small Blind ($5.95 in chips)
Seat 4: Big Blind ($1.14 in chips)
Seat 5: UTG ($6.81 in chips)
Seat 6: UTGplus1 ($9.72 in chips)
Small Blind: posts small blind $0.02
Big Blind: posts big blind $0.05
*** HOLE CARDS ***
Dealt to Hero [2h 3d]
UTG: folds
UTGplus1: folds
UTGplus2: folds
Hero: folds
Small Blind: raises $0.13 to $0.15
Big Blind: folds
Uncalled bet ($0.10) returned to Small Blind
Small Blind: doesn't show hand
Small Blind collected $0.1 from pot
*** SUMMARY ***
Total pot $0.1 | Rake $0.00
Seat 1: UTGplus2 showed
Seat 2: Hero (button) showed
Seat 3: Small Blind (small blind) won ($0.1)
Seat 4: Big Blind (big blind) showed
Seat 5: UTG showed
Seat 6: UTGplus1 showed



PokerStars Zoom Hand #3434774736: Hold'em No Limit ($0.02/$0.05) - 2017/03/09 23:41:11
Table '#952' 6-max Seat #5 is the button
Seat 1: Big Blind ($6.81 in chips)
Seat 2: UTG ($5.22 in chips)
Seat 3: Hero ($9.90 in chips)
Seat 4: UTGplus2 ($15.06 in chips)
Seat 5: Dealer ($9.92 in chips)
Seat 6: Small Blind ($9.72 in chips)
Small Blind: posts small blind $0.02
Big Blind: posts big blind $0.05
*** HOLE CARDS ***
Dealt to Hero [3c 9s]
UTG: folds
Hero: folds
UTGplus2: folds
Dealer: folds
Small Blind: folds
Big Blind: doesn't show hand
Big Blind collected $0.07 from pot
*** SUMMARY ***
Total pot $0.07 | Rake $0.00
Seat 1: Big Blind (big blind) won ($0.07)
Seat 2: UTG showed
Seat 3: Hero showed
Seat 4: UTGplus2 showed
Seat 5: Dealer (button) showed
Seat 6: Small Blind (small blind) showed



PokerStars Zoom Hand #3434774878: Hold'em No Limit ($0.02/$0.05) - 2017/03/09 23:41:28
Table '#952' 6-max Seat #3 is the button
Seat 1: UTGplus1 ($5.63 in chips)
Seat 2: Hero ($9.90 in chips)
Seat 3: Dealer ($7.31 in chips)
Seat 4: Small Blind ($8.34 in chips)
Seat 5: Big Blind ($0.64 in chips)
Seat 6: UTG ($3.49 in chips)
Small Blind: posts small blind $0.02
Big Blind: posts big blind $0.05
*** HOLE CARDS ***
Dealt to Hero [Kh 9c]
UTG: folds
UTGplus1: raises $0.10 to $0.10
Hero: folds
Dealer: folds
Small Blind: folds
Big Blind: folds
Uncalled bet ($0.05) returned to UTGplus1
UTGplus1: doesn't show hand
UTGplus1 collected $0.12 from pot
*** SUMMARY ***
Total pot $0.12 | Rake $0.00
Seat 1: UTGplus1 won ($0.12)
Seat 2: Hero showed
Seat 3: Dealer (button) showed
Seat 4: Small Blind (small blind) showed
Seat 5: Big Blind (big blind) showed
Seat 6: UTG showed



PokerStars Zoom Hand #3434774937: Hold'em No Limit ($0.02/$0.05) - 2017/03/09 23:41:37
Table '#952' 6-max Seat #1 is the button
Seat 1: Dealer ($1.93 in chips)
Seat 2: Small Blind ($7.31 in chips)
Seat 3: Big Blind ($5 in chips)
Seat 4: Hero ($9.90 in chips)
Seat 5: UTGplus1 ($6.83 in chips)
Seat 6: UTGplus2 ($9.52 in chips)
Small Blind: posts small blind $0.02
Big Blind: posts big blind $0.05
*** HOLE CARDS ***
Dealt to Hero [4c Qd]
Hero: folds
UTGplus1: folds
UTGplus2: raises $0.11 to $0.11
Dealer: folds
Small Blind: folds
Big Blind: folds
Uncalled bet ($0.06) returned to UTGplus2
UTGplus2: doesn't show hand
UTGplus2 collected $0.12 from pot
*** SUMMARY ***
Total pot $0.12 | Rake $0.00
Seat 1: Dealer (button) showed
Seat 2: Small Blind (small blind) showed
Seat 3: Big Blind (big blind) showed
Seat 4: Hero showed
Seat 5: UTGplus1 showed
Seat 6: UTGplus2 won ($0.12)



PokerStars Zoom Hand #3434774969: Hold'em No Limit ($0.02/$0.05) - 2017/03/09 23:41:42
Table '#952' 6-max Seat #5 is the button
Seat 1: Big Blind ($9.41 in chips)
Seat 2: Hero ($9.90 in chips)
Seat 3: UTGplus1 ($16.53 in chips)
Seat 4: UTGplus2 ($4.43 in chips)
Seat 5: Dealer ($13.26 in chips)
Seat 6: Small Blind ($3.42 in chips)
Small Blind: posts small blind $0.02
Big Blind: posts big blind $0.05
*** HOLE CARDS ***
Dealt to Hero [Ah Ac]
Hero: raises $0.17 to $0.17
UTGplus1: folds
UTGplus2: folds
Dealer: folds
Small Blind: folds
Big Blind: folds
Uncalled bet ($0.12) returned to Hero
Hero: doesn't show hand
Hero collected $0.12 from pot
Table deposit $0.38 
*** SUMMARY ***
Total pot $0.12 | Rake $0.00
Seat 1: Big Blind (big blind) showed
Seat 2: Hero won ($0.12)
Seat 3: UTGplus1 showed
Seat 4: UTGplus2 showed
Seat 5: Dealer (button) showed
Seat 6: Small Blind (small blind) showed



PokerStars Zoom Hand #3434775097: Hold'em No Limit ($0.02/$0.05) - 2017/03/09 23:42:00
Table '#952' 6-max Seat #5 is the button
Seat 1: Big Blind ($4.43 in chips)
Seat 2: UTG ($1.75 in chips)
Seat 3: UTGplus1 ($5.65 in chips)
Seat 4: UTGplus2 ($2.56 in chips)
Seat 5: Hero ($9.97 in chips)
Seat 6: Small Blind ($14.96 in chips)
Small Blind: posts small blind $0.02
Big Blind: posts big blind $0.05
*** HOLE CARDS ***
Dealt to Hero [7c 5c]
UTG: calls $0.05 
UTGplus1: calls $0.05 
UTGplus2: folds
Hero: raises $0.27 to $0.27
Small Blind: raises $0.52 to $0.54
Big Blind: folds
UTG: folds
UTGplus1: folds
Hero: calls $0.27 
*** FLOP *** [Ks 5d 9h]
Small Blind: checks
Hero: checks
*** TURN *** [Ks 5d 9h] [Ac]
Small Blind: checks
Hero: checks
*** RIVER *** [Ks 5d 9h Ac] [2d]
Small Blind: checks
Hero: checks
*** SHOW DOWN ***
Small Blind: shows [Qh Qs] (a pair of Queens)
Hero: shows [7c 5c] (One pair)
Small Blind collected $1.17 from pot
*** SUMMARY ***
Total pot $1.23 | Rake $0.06
Board [Ks 5d 9h Ac 2d]
Seat 1: Big Blind (big blind) showed
Seat 2: UTG showed
Seat 3: UTGplus1 showed
Seat 4: UTGplus2 showed
Seat 5: Hero (button) showed [7c 5c]
Seat 6: Small Blind (small blind) showed [Qh Qs] and won ($1.17) with a pair of Queens



PokerStars Zoom Hand #3434775584: Hold'em No Limit ($0.02/$0.05) - 2017/03/09 23:43:03
Table '#952' 6-max Seat #2 is the button
Seat 1: UTGplus2 ($4.11 in chips)
Seat 2: Dealer ($4.90 in chips)
Seat 3: Small Blind ($10.01 in chips)
Seat 4: Hero ($9.43 in chips)
Seat 5: UTG ($15.59 in chips)
Seat 6: UTGplus1 ($9.48 in chips)
Small Blind: posts small blind $0.02
Hero: posts big blind $0.05
*** HOLE CARDS ***
Dealt to Hero [Jc Qs]
UTG: raises $0.15 to $0.15
UTGplus1: calls $0.15 
UTGplus2: calls $0.15 
Dealer: calls $0.15 
Small Blind: folds
Hero: calls $0.10 
*** FLOP *** [Kd 6d Js]
Hero: checks
UTG: bets $0.55 
UTGplus1: folds
UTGplus2: folds
Dealer: folds
Hero: folds
Uncalled bet ($0.55) returned to UTG
UTG: doesn't show hand
UTG collected $0.74 from pot
*** SUMMARY ***
Total pot $0.77 | Rake $0.03
Board [Kd 6d Js]
Seat 1: UTGplus2 showed
Seat 2: Dealer (button) showed
Seat 3: Small Blind (small blind) showed
Seat 4: Hero (big blind) showed
Seat 5: UTG won ($0.74)
Seat 6: UTGplus1 showed



PokerStars Zoom Hand #3434775889: Hold'em No Limit ($0.02/$0.05) - 2017/03/09 23:43:44
Table '#952' 6-max Seat #5 is the button
Seat 1: Big Blind ($14.83 in chips)
Seat 2: UTG ($3.47 in chips)
Seat 3: Hero ($9.28 in chips)
Seat 4: UTGplus2 ($9.84 in chips)
Seat 5: Dealer ($4.78 in chips)
Seat 6: Small Blind ($2.60 in chips)
Small Blind: posts small blind $0.02
Big Blind: posts big blind $0.05
*** HOLE CARDS ***
Dealt to Hero [4d Qs]
UTG: folds
Hero: folds
UTGplus2: folds
Dealer: raises $0.10 to $0.10
Small Blind: raises $2.50 to $2.60 and is all-in
Big Blind: folds
Dealer: folds
Uncalled bet ($2.50) returned to Small Blind
Small Blind: doesn't show hand
Small Blind collected $0.25 from pot
*** SUMMARY ***
Total pot $0.25 | Rake $0.00
Seat 1: Big Blind (big blind) showed
Seat 2: UTG showed
Seat 3: Hero showed
Seat 4: UTGplus2 showed
Seat 5: Dealer (button) showed
Seat 6: Small Blind (small blind) won ($0.25)



PokerStars Zoom Hand #3434775958: Hold'em No Limit ($0.02/$0.05) - 2017/03/09 23:43:54
Table '#952' 6-max Seat #2 is the button
Seat 1: UTGplus2 ($6.43 in chips)
Seat 2: Dealer ($13.73 in chips)
Seat 3: Small Blind ($3.98 in chips)
Seat 4: Big Blind ($5.07 in chips)
Seat 5: Hero ($9.28 in chips)
Seat 6: UTGplus1 ($1.74 in chips)
Small Blind: posts small blind $0.02
Big Blind: posts big blind $0.05
*** HOLE CARDS ***
Dealt to Hero [8c Ts]
Hero: folds
UTGplus1: folds
UTGplus2: folds
Dealer: folds
Small Blind: raises $0.08 to $0.10
Big Blind: calls $0.05 
*** FLOP *** [8d 2d 6s]
Small Blind: bets $0.05 
Big Blind: calls $0.05 
*** TURN *** [8d 2d 6s] [4d]
Small Blind: bets $0.05 
Big Blind: calls $0.05 
*** RIVER *** [8d 2d 6s 4d] [3d]
Small Blind: bets $0.40 
Big Blind: folds
Uncalled bet ($0.40) returned to Small Blind
Small Blind: doesn't show hand
Small Blind collected $0.38 from pot
*** SUMMARY ***
Total pot $0.4 | Rake $0.02
Board [8d 2d 6s 4d 3d]
Seat 1: UTGplus2 showed
Seat 2: Dealer (button) showed
Seat 3: Small Blind (small blind) won ($0.38)
Seat 4: Big Blind (big blind) showed
Seat 5: Hero showed
Seat 6: UTGplus1 showed



PokerStars Zoom Hand #3434776058: Hold'em No Limit ($0.02/$0.05) - 2017/03/09 23:44:06
Table '#952' 6-max Seat #4 is the button
Seat 1: UTG ($9.66 in chips)
Seat 2: UTGplus1 ($6.62 in chips)
Seat 3: Hero ($9.28 in chips)
Seat 4: Dealer ($4.76 in chips)
Seat 5: Small Blind ($6.75 in chips)
Seat 6: Big Blind ($1.19 in chips)
Small Blind: posts small blind $0.02
Big Blind: posts big blind $0.05
*** HOLE CARDS ***
Dealt to Hero [7d 8s]
UTG: folds
UTGplus1: folds
Hero: folds
Dealer: folds
Small Blind: folds
Big Blind: doesn't show hand
Big Blind collected $0.07 from pot
*** SUMMARY ***
Total pot $0.07 | Rake $0.00
Seat 1: UTG showed
Seat 2: UTGplus1 showed
Seat 3: Hero showed
Seat 4: Dealer (button) showed
Seat 5: Small Blind (small blind) showed
Seat 6: Big Blind (big blind) won ($0.07)



PokerStars Zoom Hand #3434776162: Hold'em No Limit ($0.02/$0.05) - 2017/03/09 23:44:21
Table '#952' 6-max Seat #1 is the button
Seat 1: Dealer ($13.75 in chips)
Seat 2: Small Blind ($6.44 in chips)
Seat 3: Big Blind ($19.47 in chips)
Seat 4: UTG ($5.93 in chips)
Seat 5: Hero ($9.28 in chips)
Seat 6: UTGplus2 ($2.70 in chips)
Small Blind: posts small blind $0.02
Big Blind: posts big blind $0.05
*** HOLE CARDS ***
Dealt to Hero [Td 4c]
UTG: raises $0.15 to $0.15
Hero: folds
UTGplus2: folds
Dealer: raises $0.50 to $0.50
Small Blind: folds
Big Blind: folds
UTG: calls $0.35 
*** FLOP *** [8d 2s 3d]
UTG: checks
Dealer: checks
*** TURN *** [8d 2s 3d] [Qs]
UTG: checks
Dealer: bets $0.45 
UTG: calls $0.45 
*** RIVER *** [8d 2s 3d Qs] [8c]
UTG: checks
Dealer: bets $0.75 
UTG: calls $0.75 
*** SHOW DOWN ***
Dealer: shows [9s 5s] (a pair of Eights)
UTG: shows [9h 9c] (two pair, Nines and Queens)
UTG collected $3.3 from pot
*** SUMMARY ***
Total pot $3.47 | Rake $0.17
Board [8d 2s 3d Qs 8c]
Seat 1: Dealer (button) showed [9s 5s] and lost with a pair of Eights
Seat 2: Small Blind (small blind) showed
Seat 3: Big Blind (big blind) showed
Seat 4: UTG showed [9h 9c] and won ($3.3) with two pair, Nines and Queens
Seat 5: Hero showed
Seat 6: UTGplus2 showed



PokerStars Zoom Hand #3434776218: Hold'em No Limit ($0.02/$0.05) - 2017/03/09 23:44:28
Table '#952' 6-max Seat #3 is the button
Seat 1: UTGplus1 ($4.97 in chips)
Seat 2: UTGplus2 ($4.87 in chips)
Seat 3: Dealer ($1.21 in chips)
Seat 4: Small Blind ($1.53 in chips)
Seat 5: Hero ($9.28 in chips)
Seat 6: UTG ($4.32 in chips)
Small Blind: posts small blind $0.02
Hero: posts big blind $0.05
*** HOLE CARDS ***
Dealt to Hero [Kd 4s]
UTG: folds
UTGplus1: raises $0.15 to $0.15
UTGplus2: folds
Dealer: folds
Small Blind: folds
Hero: folds
*** SHOW DOWN ***
UTGplus1: shows [8c 6c] (high card Eight)
Uncalled bet ($0.10) returned to UTGplus1
UTGplus1 collected $0.12 from pot
*** SUMMARY ***
Total pot $0.12 | Rake $0.00
Seat 1: UTGplus1 collected ($0.12)
Seat 2: UTGplus2 showed
Seat 3: Dealer (button) showed
Seat 4: Small Blind (small blind) showed
Seat 5: Hero (big blind) showed
Seat 6: UTG showed



PokerStars Zoom Hand #3434776336: Hold'em No Limit ($0.02/$0.05) - 2017/03/09 23:44:44
Table '#952' 6-max Seat #2 is the button
Seat 1: UTGplus2 ($4.30 in chips)
Seat 2: Dealer ($4.70 in chips)
Seat 3: Hero ($9.23 in chips)
Seat 4: Big Blind ($14.76 in chips)
Seat 5: UTG ($4.18 in chips)
Seat 6: UTGplus1 ($8.08 in chips)
Hero: posts small blind $0.02
Big Blind: posts big blind $0.05
*** HOLE CARDS ***
Dealt to Hero [4s 8s]
UTG: bets $4.18 and is all-in
UTGplus1: folds
UTGplus2: folds
Dealer: folds
Hero: folds
Big Blind: folds
Uncalled bet ($4.13) returned to UTG
UTG: doesn't show hand
UTG collected $0.12 from pot
*** SUMMARY ***
Total pot $0.12 | Rake $0.00
Seat 1: UTGplus2 showed
Seat 2: Dealer (button) showed
Seat 3: Hero (small blind) showed
Seat 4: Big Blind (big blind) showed
Seat 5: UTG won ($0.12)
Seat 6: UTGplus1 showed



PokerStars Zoom Hand #3434776490: Hold'em No Limit ($0.02/$0.05) - 2017/03/09 23:45:03
Table '#952' 6-max Seat #6 is the button
Seat 1: Small Blind ($4.68 in chips)
Seat 2: Big Blind ($21.64 in chips)
Seat 3: UTG ($4.71 in chips)
Seat 4: Hero ($9.21 in chips)
Seat 5: UTGplus2 ($13 in chips)
Seat 6: Dealer ($1.44 in chips)
Small Blind: posts small blind $0.02
Big Blind: posts big blind $0.05
*** HOLE CARDS ***
Dealt to Hero [Jh 5c]
UTG: calls $0.05 
Hero: folds
UTGplus2: folds
Dealer: folds
Small Blind: folds
Big Blind: checks
*** FLOP *** [Jd 2s Ac]
Big Blind: checks
UTG: checks
*** TURN *** [Jd 2s Ac] [Kh]
Big Blind: checks
UTG: checks
*** RIVER *** [Jd 2s Ac Kh] [8c]
Big Blind: checks
UTG: checks
*** SHOW DOWN ***
Big Blind: shows [6c Ad] (a pair of Aces)
UTG: shows [4d 4h] (One pair)
Big Blind collected $0.12 from pot
Seat re-join
*** SUMMARY ***
Total pot $0.12 | Rake $0.00
Board [Jd 2s Ac Kh 8c]
Seat 1: Small Blind (small blind) showed
Seat 2: Big Blind (big blind) showed [6c Ad] and won ($0.12) with a pair of Aces
Seat 3: UTG showed [4d 4h]
Seat 4: Hero showed
Seat 5: UTGplus2 showed
Seat 6: Dealer (button) showed



PokerStars Zoom Hand #3434776575: Hold'em No Limit ($0.02/$0.05) - 2017/03/09 23:45:15
Table '#952' 6-max Seat #5 is the button
Seat 1: Big Blind ($4.30 in chips)
Seat 2: Hero ($9.21 in chips)
Seat 3: UTGplus1 ($15 in chips)
Seat 4: UTGplus2 ($0.81 in chips)
Seat 5: Dealer ($12.05 in chips)
Seat 6: Small Blind ($7.53 in chips)
Small Blind: posts small blind $0.02
Big Blind: posts big blind $0.05
*** HOLE CARDS ***
Dealt to Hero [3c 9c]
Hero: folds
UTGplus1: folds
UTGplus2: folds
Dealer: folds
Small Blind: folds
Big Blind: doesn't show hand
Big Blind collected $0.07 from pot
*** SUMMARY ***
Total pot $0.07 | Rake $0.00
Seat 1: Big Blind (big blind) won ($0.07)
Seat 2: Hero showed
Seat 3: UTGplus1 showed
Seat 4: UTGplus2 showed
Seat 5: Dealer (button) showed
Seat 6: Small Blind (small blind) showed



PokerStars Zoom Hand #3434776651: Hold'em No Limit ($0.02/$0.05) - 2017/03/09 23:45:25
Table '#952' 6-max Seat #3 is the button
Seat 1: Hero ($9.21 in chips)
Seat 2: UTGplus2 ($4.01 in chips)
Seat 3: Dealer ($4.90 in chips)
Seat 4: Small Blind ($16.05 in chips)
Seat 5: Big Blind ($3.24 in chips)
Seat 6: UTG ($0.58 in chips)
Small Blind: posts small blind $0.02
Big Blind: posts big blind $0.05
*** HOLE CARDS ***
Dealt to Hero [Jd 8s]
UTG: folds
Hero: folds
UTGplus2: calls $0.05 
Dealer: raises $0.20 to $0.20
Small Blind: folds
Big Blind: folds
UTGplus2: folds
Uncalled bet ($0.15) returned to Dealer
Dealer: doesn't show hand
Dealer collected $0.17 from pot
*** SUMMARY ***
Total pot $0.17 | Rake $0.00
Seat 1: Hero showed
Seat 2: UTGplus2 showed
Seat 3: Dealer (button) won ($0.17)
Seat 4: Small Blind (small blind) showed
Seat 5: Big Blind (big blind) showed
Seat 6: UTG showed



PokerStars Zoom Hand #3434776725: Hold'em No Limit ($0.02/$0.05) - 2017/03/09 23:45:36
Table '#952' 6-max Seat #3 is the button
Seat 1: UTGplus1 ($6.06 in chips)
Seat 2: UTGplus2 ($6.96 in chips)
Seat 3: Dealer ($4.95 in chips)
Seat 4: Small Blind ($5.34 in chips)
Seat 5: Hero ($9.21 in chips)
Seat 6: UTG ($3.62 in chips)
Small Blind: posts small blind $0.02
Hero: posts big blind $0.05
*** HOLE CARDS ***
Dealt to Hero [6h 8c]
UTG: folds
UTGplus1: folds
UTGplus2: folds
Dealer: raises $0.15 to $0.15
Small Blind: raises $0.43 to $0.45
Hero: folds
Dealer: calls $0.30 
*** FLOP *** [Ts Qc Kh]
Small Blind: checks
Dealer: bets $4.50 and is all-in
Small Blind: folds
Uncalled bet ($4.50) returned to Dealer
Dealer: doesn't show hand
Dealer collected $0.91 from pot
*** SUMMARY ***
Total pot $0.95 | Rake $0.04
Board [Ts Qc Kh]
Seat 1: UTGplus1 showed
Seat 2: UTGplus2 showed
Seat 3: Dealer (button) won ($0.91)
Seat 4: Small Blind (small blind) showed
Seat 5: Hero (big blind) showed
Seat 6: UTG showed



PokerStars Zoom Hand #3434776826: Hold'em No Limit ($0.02/$0.05) - 2017/03/09 23:45:48
Table '#952' 6-max Seat #6 is the button
Seat 1: Small Blind ($5.25 in chips)
Seat 2: Big Blind ($10.88 in chips)
Seat 3: UTG ($5.14 in chips)
Seat 4: UTGplus1 ($1.89 in chips)
Seat 5: Hero ($9.16 in chips)
Seat 6: Dealer ($16.03 in chips)
Small Blind: posts small blind $0.02
Big Blind: posts big blind $0.05
*** HOLE CARDS ***
Dealt to Hero [Th 9d]
UTG: folds
UTGplus1: folds
Hero: raises $0.17 to $0.17
Dealer: folds
Small Blind: folds
Big Blind: folds
Uncalled bet ($0.12) returned to Hero
Hero: doesn't show hand
Hero collected $0.12 from pot
Table leave user
*** SUMMARY ***
Total pot $0.12 | Rake $0.00
Seat 1: Small Blind (small blind) showed
Seat 2: Big Blind (big blind) showed
Seat 3: UTG showed
Seat 4: UTGplus1 showed
Seat 5: Hero won ($0.12)
Seat 6: Dealer (button) showed



PokerStars Zoom Hand #3434776965: Hold'em No Limit ($0.02/$0.05) - 2017/03/09 23:46:08
Table '#952' 6-max Seat #6 is the button
Seat 1: Small Blind ($5.98 in chips)
Seat 2: Big Blind ($2.33 in chips)
Seat 3: Hero ($9.23 in chips)
Seat 4: UTGplus1 ($5.23 in chips)
Seat 5: UTGplus2 ($4.51 in chips)
Seat 6: Dealer ($3.43 in chips)
Small Blind: posts small blind $0.02
Big Blind: posts big blind $0.05
*** HOLE CARDS ***
Dealt to Hero [Kc Ad]
Hero: raises $0.17 to $0.17
UTGplus1: raises $0.65 to $0.65
UTGplus2: folds
Dealer: folds
Small Blind: folds
Big Blind: folds
Hero: calls $0.48 
*** FLOP *** [8c 7s 6c]
Hero: checks
UTGplus1: bets $0.60 
Hero: calls $0.60 
*** TURN *** [8c 7s 6c] [Qh]
Hero: checks
UTGplus1: bets $1.35 
Hero: calls $1.35 
*** RIVER *** [8c 7s 6c Qh] [Kh]
Hero: checks
UTGplus1: bets $2.63 and is all-in
Hero: calls $2.63 
*** SHOW DOWN ***
UTGplus1: shows [Qd Qs] (three of a kind, Queens)
Hero: shows [Kc Ad] (One pair)
UTGplus1 collected $10.01 from pot
Seat re-join
Seat re-join
*** SUMMARY ***
Total pot $10.53 | Rake $0.52
Board [8c 7s 6c Qh Kh]
Seat 1: Small Blind (small blind) showed
Seat 2: Big Blind (big blind) showed
Seat 3: Hero showed [Kc Ad]
Seat 4: UTGplus1 showed [Qd Qs] and won ($10.01) with three of a kind, Queens
Seat 5: UTGplus2 showed
Seat 6: Dealer (button) showed



PokerStars Zoom Hand #3434777636: Hold'em No Limit ($0.02/$0.05) - 2017/03/09 23:47:36
Table '#952' 6-max Seat #1 is the button
Seat 1: Dealer ($4.98 in chips)
Seat 2: Small Blind ($2.35 in chips)
Seat 3: Big Blind ($4.36 in chips)
Seat 4: UTG ($4.96 in chips)
Seat 5: UTGplus1 ($9.03 in chips)
Seat 6: Hero ($4 in chips)
Small Blind: posts small blind $0.02
Big Blind: posts big blind $0.05
*** HOLE CARDS ***
Dealt to Hero [Kc Kd]
UTG: folds
UTGplus1: folds
Hero: raises $0.17 to $0.17
Dealer: raises $0.54 to $0.54
Small Blind: folds
Big Blind: folds
Hero: raises $1.52 to $1.69
Dealer: folds
Uncalled bet ($1.15) returned to Hero
Hero: doesn't show hand
Hero collected $1.15 from pot
*** SUMMARY ***
Total pot $1.15 | Rake $0.00
Seat 1: Dealer (button) showed
Seat 2: Small Blind (small blind) showed
Seat 3: Big Blind (big blind) showed
Seat 4: UTG showed
Seat 5: UTGplus1 showed
Seat 6: Hero won ($1.15)



PokerStars Zoom Hand #3434777951: Hold'em No Limit ($0.02/$0.05) - 2017/03/09 23:48:19
Table '#952' 6-max Seat #5 is the button
Seat 1: Big Blind ($5 in chips)
Seat 2: UTG ($4.03 in chips)
Seat 3: UTGplus1 ($22.28 in chips)
Seat 4: UTGplus2 ($12.47 in chips)
Seat 5: Dealer ($5.12 in chips)
Seat 6: Hero ($4.61 in chips)
Hero: posts small blind $0.02
Big Blind: posts big blind $0.05
*** HOLE CARDS ***
Dealt to Hero [Qs Tc]
UTG: folds
UTGplus1: folds
UTGplus2: folds
Dealer: folds
Hero: raises $0.13 to $0.15
Big Blind: calls $0.10 
*** FLOP *** [6d Td 8s]
Hero: bets $0.20 
Big Blind: folds
Uncalled bet ($0.20) returned to Hero
Hero: doesn't show hand
Hero collected $0.29 from pot
*** SUMMARY ***
Total pot $0.3 | Rake $0.01
Board [6d Td 8s]
Seat 1: Big Blind (big blind) showed
Seat 2: UTG showed
Seat 3: UTGplus1 showed
Seat 4: UTGplus2 showed
Seat 5: Dealer (button) showed
Seat 6: Hero (small blind) won ($0.29)



PokerStars Zoom Hand #3434778253: Hold'em No Limit ($0.02/$0.05) - 2017/03/09 23:48:58
Table '#952' 6-max Seat #2 is the button
Seat 1: Hero ($4.75 in chips)
Seat 2: Dealer ($14.75 in chips)
Seat 3: Small Blind ($4.85 in chips)
Seat 4: Big Blind ($3.66 in chips)
Seat 5: UTG ($10.65 in chips)
Seat 6: UTGplus1 ($6.74 in chips)
Small Blind: posts small blind $0.02
Big Blind: posts big blind $0.05
*** HOLE CARDS ***
Dealt to Hero [7c 9h]
UTG: folds
UTGplus1: folds
Hero: folds
Dealer: raises $0.15 to $0.15
Small Blind: folds
Big Blind: calls $0.10 
*** FLOP *** [4d Ts 6s]
Big Blind: checks
Dealer: bets $0.20 
Big Blind: calls $0.20 
*** TURN *** [4d Ts 6s] [Qc]
Big Blind: checks
Dealer: checks
*** RIVER *** [4d Ts 6s Qc] [3h]
Big Blind: checks
Dealer: checks
*** SHOW DOWN ***
Big Blind: shows [As 5s] (high card Ace)
Dealer: shows [7h 4h] (a pair of Fours)
Dealer collected $0.69 from pot
Seat re-join
Table deposit $5 
Seat re-join
*** SUMMARY ***
Total pot $0.72 | Rake $0.03
Board [4d Ts 6s Qc 3h]
Seat 1: Hero showed
Seat 2: Dealer (button) showed [7h 4h] and won ($0.69) with a pair of Fours
Seat 3: Small Blind (small blind) showed
Seat 4: Big Blind (big blind) showed [As 5s-As Qc Ts 6s 5s] and lost with high card Ace
Seat 5: UTG showed
Seat 6: UTGplus1 showed



PokerStars Zoom Hand #3434778320: Hold'em No Limit ($0.02/$0.05) - 2017/03/09 23:49:06
Table '#952' 6-max Seat #5 is the button
Seat 1: Hero ($4.75 in chips)
Seat 2: UTG ($5.30 in chips)
Seat 3: UTGplus1 ($11.73 in chips)
Seat 4: UTGplus2 ($5.77 in chips)
Seat 5: Dealer ($4.85 in chips)
Seat 6: Small Blind ($7.63 in chips)
Small Blind: posts small blind $0.02
Hero: posts big blind $0.05
*** HOLE CARDS ***
Dealt to Hero [Jd Td]
UTG: folds
UTGplus1: folds
UTGplus2: folds
Dealer: calls $0.05 
Small Blind: calls $0.03 
Hero: raises $0.15 to $0.20
Dealer: calls $0.15 
Small Blind: folds
*** FLOP *** [6s 6c Ts]
Hero: bets $0.35 
Dealer: folds
Uncalled bet ($0.35) returned to Hero
Hero: doesn't show hand
Hero collected $0.43 from pot
*** SUMMARY ***
Total pot $0.45 | Rake $0.02
Board [6s 6c Ts]
Seat 1: Hero (big blind) won ($0.43)
Seat 2: UTG showed
Seat 3: UTGplus1 showed
Seat 4: UTGplus2 showed
Seat 5: Dealer (button) showed
Seat 6: Small Blind (small blind) showed



PokerStars Zoom Hand #3434778693: Hold'em No Limit ($0.02/$0.05) - 2017/03/09 23:49:55
Table '#952' 6-max Seat #2 is the button
Seat 1: UTGplus2 ($5.30 in chips)
Seat 2: Dealer ($15.11 in chips)
Seat 3: Small Blind ($8.51 in chips)
Seat 4: Big Blind ($5.49 in chips)
Seat 5: UTG ($5.78 in chips)
Seat 6: Hero ($4.98 in chips)
Small Blind: posts small blind $0.02
Big Blind: posts big blind $0.05
*** HOLE CARDS ***
Dealt to Hero [6s Qh]
UTG: folds
Hero: folds
UTGplus2: folds
Dealer: raises $0.15 to $0.15
Small Blind: folds
Big Blind: calls $0.10 
*** FLOP *** [9s Js 7h]
Big Blind: checks
Dealer: bets $0.20 
Big Blind: folds
Uncalled bet ($0.20) returned to Dealer
Dealer: doesn't show hand
Dealer collected $0.31 from pot
*** SUMMARY ***
Total pot $0.32 | Rake $0.01
Board [9s Js 7h]
Seat 1: UTGplus2 showed
Seat 2: Dealer (button) won ($0.31)
Seat 3: Small Blind (small blind) showed
Seat 4: Big Blind (big blind) showed
Seat 5: UTG showed
Seat 6: Hero showed



PokerStars Zoom Hand #3434778736: Hold'em No Limit ($0.02/$0.05) - 2017/03/09 23:50:01
Table '#952' 6-max Seat #1 is the button
Seat 1: Hero ($4.98 in chips)
Seat 2: Small Blind ($4.23 in chips)
Seat 3: Big Blind ($4.81 in chips)
Seat 4: UTG ($7.17 in chips)
Seat 5: UTGplus1 ($1.60 in chips)
Seat 6: UTGplus2 ($3.62 in chips)
Small Blind: posts small blind $0.02
Big Blind: posts big blind $0.05
*** HOLE CARDS ***
Dealt to Hero [Qd Jh]
UTG: folds
UTGplus1: folds
UTGplus2: raises $0.10 to $0.10
Hero: raises $0.32 to $0.32
Small Blind: folds
Big Blind: folds
UTGplus2: calls $0.22 
*** FLOP *** [Ad 9c Ks]
UTGplus2: checks
Hero: bets $0.40 
UTGplus2: folds
Uncalled bet ($0.40) returned to Hero
Hero: doesn't show hand
Hero collected $0.68 from pot
Seat re-join
*** SUMMARY ***
Total pot $0.71 | Rake $0.03
Board [Ad 9c Ks]
Seat 1: Hero (button) won ($0.68)
Seat 2: Small Blind (small blind) showed
Seat 3: Big Blind (big blind) showed
Seat 4: UTG showed
Seat 5: UTGplus1 showed
Seat 6: UTGplus2 showed



PokerStars Zoom Hand #3434779091: Hold'em No Limit ($0.02/$0.05) - 2017/03/09 23:50:50
Table '#952' 6-max Seat #1 is the button
Seat 1: Dealer ($8.12 in chips)
Seat 2: Small Blind ($4.91 in chips)
Seat 3: Big Blind ($4.09 in chips)
Seat 4: UTG ($16.88 in chips)
Seat 5: UTGplus1 ($3.59 in chips)
Seat 6: Hero ($5.34 in chips)
Small Blind: posts small blind $0.02
Big Blind: posts big blind $0.05
*** HOLE CARDS ***
Dealt to Hero [8d Ah]
UTG: folds
UTGplus1: folds
Hero: folds
Dealer: raises $0.15 to $0.15
Small Blind: folds
Big Blind: folds
Uncalled bet ($0.10) returned to Dealer
Dealer: doesn't show hand
Dealer collected $0.12 from pot
*** SUMMARY ***
Total pot $0.12 | Rake $0.00
Seat 1: Dealer (button) won ($0.12)
Seat 2: Small Blind (small blind) showed
Seat 3: Big Blind (big blind) showed
Seat 4: UTG showed
Seat 5: UTGplus1 showed
Seat 6: Hero showed



PokerStars Zoom Hand #3434779136: Hold'em No Limit ($0.02/$0.05) - 2017/03/09 23:50:56
Table '#952' 6-max Seat #5 is the button
Seat 1: Big Blind ($1.86 in chips)
Seat 2: UTG ($5.85 in chips)
Seat 3: UTGplus1 ($9.62 in chips)
Seat 4: Hero ($5.34 in chips)
Seat 5: Dealer ($4.89 in chips)
Seat 6: Small Blind ($3.59 in chips)
Small Blind: posts small blind $0.02
Big Blind: posts big blind $0.05
*** HOLE CARDS ***
Dealt to Hero [Tc 6s]
UTG: calls $0.05 
UTGplus1: folds
Hero: folds
Dealer: raises $0.20 to $0.20
Small Blind: folds
Big Blind: calls $0.15 
UTG: calls $0.15 
*** FLOP *** [3d Kh 9h]
Big Blind: checks
UTG: checks
Dealer: bets $0.31 
Big Blind: folds
UTG: folds
Uncalled bet ($0.31) returned to Dealer
Dealer: doesn't show hand
Dealer collected $0.59 from pot
*** SUMMARY ***
Total pot $0.62 | Rake $0.03
Board [3d Kh 9h]
Seat 1: Big Blind (big blind) showed
Seat 2: UTG showed
Seat 3: UTGplus1 showed
Seat 4: Hero showed
Seat 5: Dealer (button) won ($0.59)
Seat 6: Small Blind (small blind) showed



PokerStars Zoom Hand #3434779176: Hold'em No Limit ($0.02/$0.05) - 2017/03/09 23:51:00
Table '#952' 6-max Seat #3 is the button
Seat 1: UTGplus1 ($9.62 in chips)
Seat 2: UTGplus2 ($5.42 in chips)
Seat 3: Dealer ($2.73 in chips)
Seat 4: Small Blind ($15.27 in chips)
Seat 5: Big Blind ($3.57 in chips)
Seat 6: Hero ($5.34 in chips)
Small Blind: posts small blind $0.02
Big Blind: posts big blind $0.05
*** HOLE CARDS ***
Dealt to Hero [6d Th]
Hero: folds
UTGplus1: folds
UTGplus2: folds
Dealer: raises $0.10 to $0.10
Small Blind: folds
Big Blind: raises $0.35 to $0.40
Dealer: raises $0.60 to $0.70
Big Blind: folds
*** SHOW DOWN ***
Dealer: shows [8d 3h] (high card Eight)
Uncalled bet ($0.30) returned to Dealer
Dealer collected $0.82 from pot
Table deposit $2.50 
*** SUMMARY ***
Total pot $0.82 | Rake $0.00
Seat 1: UTGplus1 showed
Seat 2: UTGplus2 showed
Seat 3: Dealer (button) collected ($0.82)
Seat 4: Small Blind (small blind) showed
Seat 5: Big Blind (big blind) showed
Seat 6: Hero showed



PokerStars Zoom Hand #3434779216: Hold'em No Limit ($0.02/$0.05) - 2017/03/09 23:51:05
Table '#952' 6-max Seat #4 is the button
Seat 1: UTG ($7.10 in chips)
Seat 2: UTGplus1 ($4.04 in chips)
Seat 3: UTGplus2 ($5.24 in chips)
Seat 4: Hero ($5.34 in chips)
Seat 5: Small Blind ($11.73 in chips)
Seat 6: Big Blind ($6.11 in chips)
Small Blind: posts small blind $0.02
Big Blind: posts big blind $0.05
*** HOLE CARDS ***
Dealt to Hero [Ks 7c]
UTG: folds
UTGplus1: folds
UTGplus2: folds
Hero: folds
Small Blind: calls $0.03 
Big Blind: checks
*** FLOP *** [Jd 6c Tc]
Small Blind: checks
Big Blind: checks
*** TURN *** [Jd 6c Tc] [Qh]
Small Blind: bets $0.10 
Big Blind: folds
Uncalled bet ($0.10) returned to Small Blind
Small Blind: doesn't show hand
Small Blind collected $0.1 from pot
*** SUMMARY ***
Total pot $0.1 | Rake $0.00
Board [Jd 6c Tc Qh]
Seat 1: UTG showed
Seat 2: UTGplus1 showed
Seat 3: UTGplus2 showed
Seat 4: Hero (button) showed
Seat 5: Small Blind (small blind) won ($0.1)
Seat 6: Big Blind (big blind) showed



PokerStars Zoom Hand #3434779265: Hold'em No Limit ($0.02/$0.05) - 2017/03/09 23:51:12
Table '#952' 6-max Seat #6 is the button
Seat 1: Small Blind ($9.14 in chips)
Seat 2: Hero ($5.34 in chips)
Seat 3: UTG ($15.23 in chips)
Seat 4: UTGplus1 ($16.05 in chips)
Seat 5: UTGplus2 ($7.55 in chips)
Seat 6: Dealer ($6.92 in chips)
Small Blind: posts small blind $0.02
Hero: posts big blind $0.05
*** HOLE CARDS ***
Dealt to Hero [5d 6d]
UTG: folds
UTGplus1: folds
UTGplus2: folds
Dealer: folds
Small Blind: folds
Hero: doesn't show hand
Hero collected $0.07 from pot
Table deposit $5 
Table deposit $2.50 
*** SUMMARY ***
Total pot $0.07 | Rake $0.00
Seat 1: Small Blind (small blind) showed
Seat 2: Hero (big blind) won ($0.07)
Seat 3: UTG showed
Seat 4: UTGplus1 showed
Seat 5: UTGplus2 showed
Seat 6: Dealer (button) showed



PokerStars Zoom Hand #3434779414: Hold'em No Limit ($0.02/$0.05) - 2017/03/09 23:51:30
Table '#952' 6-max Seat #1 is the button
Seat 1: Dealer ($8.19 in chips)
Seat 2: Hero ($5.36 in chips)
Seat 3: Big Blind ($5.65 in chips)
Seat 4: UTG ($3.32 in chips)
Seat 5: UTGplus1 ($1.69 in chips)
Seat 6: UTGplus2 ($10.30 in chips)
Hero: posts small blind $0.02
Big Blind: posts big blind $0.05
*** HOLE CARDS ***
Dealt to Hero [8h Qh]
UTG: folds
UTGplus1: folds
UTGplus2: folds
Dealer: folds
Hero: raises $0.13 to $0.15
Big Blind: calls $0.10 
*** FLOP *** [9c 5h 3h]
Hero: bets $0.20 
Big Blind: folds & shows [3d Qc] 
Uncalled bet ($0.20) returned to Hero
Hero: doesn't show hand
Hero collected $0.29 from pot
*** SUMMARY ***
Total pot $0.3 | Rake $0.01
Board [9c 5h 3h]
Seat 1: Dealer (button) showed
Seat 2: Hero (small blind) won ($0.29)
Seat 3: Big Blind (big blind) showed
Seat 4: UTG showed
Seat 5: UTGplus1 showed
Seat 6: UTGplus2 showed



PokerStars Zoom Hand #3434779729: Hold'em No Limit ($0.02/$0.05) - 2017/03/09 23:52:12
Table '#952' 6-max Seat #3 is the button
Seat 1: UTGplus1 ($9.37 in chips)
Seat 2: UTGplus2 ($4.13 in chips)
Seat 3: Dealer ($6.96 in chips)
Seat 4: Small Blind ($10.07 in chips)
Seat 5: Big Blind ($2.95 in chips)
Seat 6: Hero ($5.50 in chips)
Small Blind: posts small blind $0.02
Big Blind: posts big blind $0.05
*** HOLE CARDS ***
Dealt to Hero [2d 3c]
Hero: folds
UTGplus1: raises $0.15 to $0.15
UTGplus2: folds
Dealer: raises $0.52 to $0.52
Small Blind: folds
Big Blind: folds
UTGplus1: folds
Uncalled bet ($0.37) returned to Dealer
Dealer: doesn't show hand
Dealer collected $0.37 from pot
*** SUMMARY ***
Total pot $0.37 | Rake $0.00
Seat 1: UTGplus1 showed
Seat 2: UTGplus2 showed
Seat 3: Dealer (button) won ($0.37)
Seat 4: Small Blind (small blind) showed
Seat 5: Big Blind (big blind) showed
Seat 6: Hero showed



PokerStars Zoom Hand #3434779789: Hold'em No Limit ($0.02/$0.05) - 2017/03/09 23:52:20
Table '#952' 6-max Seat #2 is the button
Seat 1: Hero ($5.50 in chips)
Seat 2: Dealer ($3.21 in chips)
Seat 3: Small Blind ($10.05 in chips)
Seat 4: Big Blind ($4.13 in chips)
Seat 5: UTG ($1.48 in chips)
Seat 6: UTGplus1 ($5.66 in chips)
Small Blind: posts small blind $0.02
Big Blind: posts big blind $0.05
*** HOLE CARDS ***
Dealt to Hero [4d 9d]
UTG: raises $0.10 to $0.10
UTGplus1: folds
Hero: folds
Dealer: raises $0.25 to $0.25
Small Blind: folds
Big Blind: folds
UTG: calls $0.15 
*** FLOP *** [5h 4s Ah]
UTG: checks
Dealer: checks
*** TURN *** [5h 4s Ah] [Qs]
UTG: checks
Dealer: checks
*** RIVER *** [5h 4s Ah Qs] [8s]
UTG: checks
Dealer: bets $0.25 
UTG: raises $0.98 to $1.23 and is all-in
Dealer: calls $0.98 
*** SHOW DOWN ***
UTG: shows [5d 7d] (a pair of Fives)
Dealer: shows [Kh Ks] (a pair of Kings)
Dealer collected $2.88 from pot
*** SUMMARY ***
Total pot $3.03 | Rake $0.15
Board [5h 4s Ah Qs 8s]
Seat 1: Hero showed
Seat 2: Dealer (button) showed [Kh Ks] and won ($2.88) with a pair of Kings
Seat 3: Small Blind (small blind) showed
Seat 4: Big Blind (big blind) showed
Seat 5: UTG showed [5d 7d] and lost with a pair of Fives
Seat 6: UTGplus1 showed



PokerStars Zoom Hand #3434779842: Hold'em No Limit ($0.02/$0.05) - 2017/03/09 23:52:27
Table '#952' 6-max Seat #6 is the button
Seat 1: Hero ($5.50 in chips)
Seat 2: Big Blind ($6.85 in chips)
Seat 3: UTG ($2.35 in chips)
Seat 4: UTGplus1 ($9.40 in chips)
Seat 5: UTGplus2 ($6.05 in chips)
Seat 6: Dealer ($1.46 in chips)
Hero: posts small blind $0.02
Big Blind: posts big blind $0.05
*** HOLE CARDS ***
Dealt to Hero [4c 4d]
UTG: folds
UTGplus1: folds
UTGplus2: folds
Dealer: folds
Hero: raises $0.13 to $0.15
Big Blind: folds
Uncalled bet ($0.10) returned to Hero
Hero: doesn't show hand
Hero collected $0.1 from pot
Table deposit $5 
*** SUMMARY ***
Total pot $0.1 | Rake $0.00
Seat 1: Hero (small blind) won ($0.1)
Seat 2: Big Blind (big blind) showed
Seat 3: UTG showed
Seat 4: UTGplus1 showed
Seat 5: UTGplus2 showed
Seat 6: Dealer (button) showed



PokerStars Zoom Hand #3434780025: Hold'em No Limit ($0.02/$0.05) - 2017/03/09 23:52:52
Table '#952' 6-max Seat #5 is the button
Seat 1: Hero ($5.55 in chips)
Seat 2: UTG ($6.90 in chips)
Seat 3: UTGplus1 ($7.18 in chips)
Seat 4: UTGplus2 ($6.80 in chips)
Seat 5: Dealer ($4.49 in chips)
Seat 6: Small Blind ($21.04 in chips)
Small Blind: posts small blind $0.02
Hero: posts big blind $0.05
*** HOLE CARDS ***
Dealt to Hero [Qd 8s]
UTG: raises $0.15 to $0.15
UTGplus1: folds
UTGplus2: folds
Dealer: calls $0.15 
Small Blind: folds
Hero: folds
*** FLOP *** [Ks Qh 8h]
UTG: bets $0.18 
Dealer: calls $0.18 
*** TURN *** [Ks Qh 8h] [5h]
UTG: bets $0.36 
Dealer: raises $1.12 to $1.12
UTG: folds
Uncalled bet ($0.76) returned to Dealer
Dealer: doesn't show hand
Dealer collected $1.38 from pot
*** SUMMARY ***
Total pot $1.45 | Rake $0.07
Board [Ks Qh 8h 5h]
Seat 1: Hero (big blind) showed
Seat 2: UTG showed
Seat 3: UTGplus1 showed
Seat 4: UTGplus2 showed
Seat 5: Dealer (button) won ($1.38)
Seat 6: Small Blind (small blind) showed



PokerStars Zoom Hand #3434780072: Hold'em No Limit ($0.02/$0.05) - 2017/03/09 23:52:59
Table '#952' 6-max Seat #4 is the button
Seat 1: UTG ($4.37 in chips)
Seat 2: UTGplus1 ($8.53 in chips)
Seat 3: Hero ($5.50 in chips)
Seat 4: Dealer ($9.15 in chips)
Seat 5: Small Blind ($9.11 in chips)
Seat 6: Big Blind ($2.50 in chips)
Small Blind: posts small blind $0.02
Big Blind: posts big blind $0.05
*** HOLE CARDS ***
Dealt to Hero [8s Kh]
UTG: folds
UTGplus1: folds
Hero: folds
Dealer: raises $0.15 to $0.15
Small Blind: folds
Big Blind: folds
Uncalled bet ($0.10) returned to Dealer
Dealer: doesn't show hand
Dealer collected $0.12 from pot
*** SUMMARY ***
Total pot $0.12 | Rake $0.00
Seat 1: UTG showed
Seat 2: UTGplus1 showed
Seat 3: Hero showed
Seat 4: Dealer (button) won ($0.12)
Seat 5: Small Blind (small blind) showed
Seat 6: Big Blind (big blind) showed



PokerStars Zoom Hand #3434780115: Hold'em No Limit ($0.02/$0.05) - 2017/03/09 23:53:04
Table '#952' 6-max Seat #4 is the button
Seat 1: UTG ($5.35 in chips)
Seat 2: UTGplus1 ($5.21 in chips)
Seat 3: UTGplus2 ($4.95 in chips)
Seat 4: Dealer ($9.09 in chips)
Seat 5: Hero ($5.50 in chips)
Seat 6: Big Blind ($4.37 in chips)
Hero: posts small blind $0.02
Big Blind: posts big blind $0.05
*** HOLE CARDS ***
Dealt to Hero [Qh 6s]
UTG: folds
UTGplus1: folds
UTGplus2: raises $0.15 to $0.15
Dealer: folds
Hero: folds
Big Blind: folds
Uncalled bet ($0.10) returned to UTGplus2
UTGplus2: doesn't show hand
UTGplus2 collected $0.12 from pot
Table deposit $2.50 
*** SUMMARY ***
Total pot $0.12 | Rake $0.00
Seat 1: UTG showed
Seat 2: UTGplus1 showed
Seat 3: UTGplus2 won ($0.12)
Seat 4: Dealer (button) showed
Seat 5: Hero (small blind) showed
Seat 6: Big Blind (big blind) showed



PokerStars Zoom Hand #3434780144: Hold'em No Limit ($0.02/$0.05) - 2017/03/09 23:53:08
Table '#952' 6-max Seat #1 is the button
Seat 1: Dealer ($2.87 in chips)
Seat 2: Small Blind ($3.98 in chips)
Seat 3: Big Blind ($8.62 in chips)
Seat 4: UTG ($4.53 in chips)
Seat 5: UTGplus1 ($9.09 in chips)
Seat 6: Hero ($5.48 in chips)
Small Blind: posts small blind $0.02
Big Blind: posts big blind $0.05
*** HOLE CARDS ***
Dealt to Hero [9c 3h]
UTG: folds
UTGplus1: folds
Hero: folds
Dealer: raises $0.15 to $0.15
Small Blind: folds
Big Blind: folds
Uncalled bet ($0.10) returned to Dealer
Dealer: doesn't show hand
Dealer collected $0.12 from pot
*** SUMMARY ***
Total pot $0.12 | Rake $0.00
Seat 1: Dealer (button) won ($0.12)
Seat 2: Small Blind (small blind) showed
Seat 3: Big Blind (big blind) showed
Seat 4: UTG showed
Seat 5: UTGplus1 showed
Seat 6: Hero showed



PokerStars Zoom Hand #3434780168: Hold'em No Limit ($0.02/$0.05) - 2017/03/09 23:53:12
Table '#952' 6-max Seat #5 is the button
Seat 1: Big Blind ($4.10 in chips)
Seat 2: UTG ($5.12 in chips)
Seat 3: UTGplus1 ($4.53 in chips)
Seat 4: UTGplus2 ($7.74 in chips)
Seat 5: Hero ($5.48 in chips)
Seat 6: Small Blind ($21.02 in chips)
Small Blind: posts small blind $0.02
Big Blind: posts big blind $0.05
*** HOLE CARDS ***
Dealt to Hero [Th 6s]
UTG: folds
UTGplus1: folds
UTGplus2: folds
Hero: folds
Small Blind: raises $0.13 to $0.15
Big Blind: folds
Uncalled bet ($0.10) returned to Small Blind
Small Blind: doesn't show hand
Small Blind collected $0.1 from pot
Table deposit $0.68 
*** SUMMARY ***
Total pot $0.1 | Rake $0.00
Seat 1: Big Blind (big blind) showed
Seat 2: UTG showed
Seat 3: UTGplus1 showed
Seat 4: UTGplus2 showed
Seat 5: Hero (button) showed
Seat 6: Small Blind (small blind) won ($0.1)



PokerStars Zoom Hand #3434780189: Hold'em No Limit ($0.02/$0.05) - 2017/03/09 23:53:16
Table '#952' 6-max Seat #2 is the button
Seat 1: UTGplus2 ($6.69 in chips)
Seat 2: Dealer ($9.33 in chips)
Seat 3: Small Blind ($5.51 in chips)
Seat 4: Big Blind ($7.74 in chips)
Seat 5: Hero ($5.48 in chips)
Seat 6: UTGplus1 ($2.13 in chips)
Small Blind: posts small blind $0.02
Big Blind: posts big blind $0.05
*** HOLE CARDS ***
Dealt to Hero [2s 5s]
Hero: folds
UTGplus1: folds
UTGplus2: folds
Dealer: folds
Small Blind: folds
Big Blind: doesn't show hand
Big Blind collected $0.07 from pot
*** SUMMARY ***
Total pot $0.07 | Rake $0.00
Seat 1: UTGplus2 showed
Seat 2: Dealer (button) showed
Seat 3: Small Blind (small blind) showed
Seat 4: Big Blind (big blind) won ($0.07)
Seat 5: Hero showed
Seat 6: UTGplus1 showed



PokerStars Zoom Hand #3434780224: Hold'em No Limit ($0.02/$0.05) - 2017/03/09 23:53:21
Table '#952' 6-max Seat #2 is the button
Seat 1: UTGplus2 ($9.22 in chips)
Seat 2: Dealer ($2.29 in chips)
Seat 3: Small Blind ($15.35 in chips)
Seat 4: Hero ($5.48 in chips)
Seat 5: UTG ($4.17 in chips)
Seat 6: UTGplus1 ($5.57 in chips)
Small Blind: posts small blind $0.02
Hero: posts big blind $0.05
*** HOLE CARDS ***
Dealt to Hero [7h Td]
UTG: folds
UTGplus1: raises $0.17 to $0.17
UTGplus2: folds
Dealer: folds
Small Blind: calls $0.15 
Hero: folds
*** FLOP *** [Jd 8d 2s]
Small Blind: checks
UTGplus1: bets $0.19 
Small Blind: folds
Uncalled bet ($0.19) returned to UTGplus1
UTGplus1: doesn't show hand
UTGplus1 collected $0.38 from pot
*** SUMMARY ***
Total pot $0.39 | Rake $0.01
Board [Jd 8d 2s]
Seat 1: UTGplus2 showed
Seat 2: Dealer (button) showed
Seat 3: Small Blind (small blind) showed
Seat 4: Hero (big blind) showed
Seat 5: UTG showed
Seat 6: UTGplus1 won ($0.38)



PokerStars Zoom Hand #3434780266: Hold'em No Limit ($0.02/$0.05) - 2017/03/09 23:53:27
Table '#952' 6-max Seat #1 is the button
Seat 1: Hero ($5.43 in chips)
Seat 2: Small Blind ($4.34 in chips)
Seat 3: Big Blind ($6.69 in chips)
Seat 4: UTG ($2.80 in chips)
Seat 5: UTGplus1 ($20.05 in chips)
Seat 6: UTGplus2 ($4.05 in chips)
Small Blind: posts small blind $0.02
Big Blind: posts big blind $0.05
*** HOLE CARDS ***
Dealt to Hero [Th 6h]
UTG: folds
UTGplus1: folds
UTGplus2: raises $0.15 to $0.15
Hero: folds
Small Blind: folds
Big Blind: folds
Uncalled bet ($0.10) returned to UTGplus2
UTGplus2: doesn't show hand
UTGplus2 collected $0.12 from pot
*** SUMMARY ***
Total pot $0.12 | Rake $0.00
Seat 1: Hero (button) showed
Seat 2: Small Blind (small blind) showed
Seat 3: Big Blind (big blind) showed
Seat 4: UTG showed
Seat 5: UTGplus1 showed
Seat 6: UTGplus2 won ($0.12)



PokerStars Zoom Hand #3434780378: Hold'em No Limit ($0.02/$0.05) - 2017/03/09 23:53:43
Table '#952' 6-max Seat #1 is the button
Seat 1: Dealer ($6.16 in chips)
Seat 2: Small Blind ($4.24 in chips)
Seat 3: Big Blind ($2.94 in chips)
Seat 4: UTG ($2.29 in chips)
Seat 5: Hero ($5.43 in chips)
Seat 6: UTGplus2 ($3.15 in chips)
Small Blind: posts small blind $0.02
Big Blind: posts big blind $0.05
*** HOLE CARDS ***
Dealt to Hero [Js 7c]
UTG: folds
Hero: folds
UTGplus2: folds
Dealer: folds
Small Blind: calls $0.03 
Big Blind: checks
*** FLOP *** [4d Qc Kc]
Small Blind: bets $0.15 
Big Blind: folds
*** SHOW DOWN ***
Small Blind: shows [Kh 6h] (a pair of Kings)
Uncalled bet ($0.15) returned to Small Blind
Small Blind collected $0.1 from pot
*** SUMMARY ***
Total pot $0.1 | Rake $0.00
Board [4d Qc Kc]
Seat 1: Dealer (button) showed
Seat 2: Small Blind (small blind) showed [Kh 6h] and won ($0.1) with a pair of Kings
Seat 3: Big Blind (big blind) showed
Seat 4: UTG showed
Seat 5: Hero showed
Seat 6: UTGplus2 showed



PokerStars Zoom Hand #3434780427: Hold'em No Limit ($0.02/$0.05) - 2017/03/09 23:53:49
Table '#952' 6-max Seat #2 is the button
Seat 1: Hero ($5.43 in chips)
Seat 2: Dealer ($7.11 in chips)
Seat 3: Small Blind ($7.76 in chips)
Seat 4: Big Blind ($19.35 in chips)
Seat 5: UTG ($4.24 in chips)
Seat 6: UTGplus1 ($3.15 in chips)
Small Blind: posts small blind $0.02
Big Blind: posts big blind $0.05
*** HOLE CARDS ***
Dealt to Hero [Th 7h]
UTG: folds
UTGplus1: raises $0.15 to $0.15
Hero: calls $0.15 
Dealer: folds
Small Blind: calls $0.13 
Big Blind: calls $0.10 
*** FLOP *** [Td 6h 7c]
Small Blind: checks
Big Blind: checks
UTGplus1: checks
Hero: bets $0.30 
Small Blind: folds
Big Blind: raises $0.65 to $0.65
UTGplus1: folds
Hero: calls $0.35 
*** TURN *** [Td 6h 7c] [Ad]
Big Blind: bets $1 
Hero: calls $1 
*** RIVER *** [Td 6h 7c Ad] [9d]
Big Blind: checks
Hero: checks
*** SHOW DOWN ***
Big Blind: shows [6d 6s] (three of a kind, Sixs)
Hero: shows [Th 7h] (Two pair)
Big Blind collected $3.71 from pot
*** SUMMARY ***
Total pot $3.9 | Rake $0.19
Board [Td 6h 7c Ad 9d]
Seat 1: Hero showed [Th 7h]
Seat 2: Dealer (button) showed
Seat 3: Small Blind (small blind) showed
Seat 4: Big Blind (big blind) showed [6d 6s] and won ($3.71) with three of a kind, Sixes
Seat 5: UTG showed
Seat 6: UTGplus1 showed



PokerStars Zoom Hand #3434780930: Hold'em No Limit ($0.02/$0.05) - 2017/03/09 23:55:02
Table '#952' 6-max Seat #4 is the button
Seat 1: UTG ($8.32 in chips)
Seat 2: Hero ($3.63 in chips)
Seat 3: UTGplus2 ($21.26 in chips)
Seat 4: Dealer ($3 in chips)
Seat 5: Small Blind ($20.18 in chips)
Seat 6: Big Blind ($7.46 in chips)
Small Blind: posts small blind $0.02
Big Blind: posts big blind $0.05
*** HOLE CARDS ***
Dealt to Hero [3s 6s]
UTG: folds
Hero: folds
UTGplus2: folds
Dealer: raises $0.15 to $0.15
Small Blind: folds
Big Blind: calls $0.10 
*** FLOP *** [6d 5c 4c]
Big Blind: bets $0.16 
Dealer: calls $0.16 
*** TURN *** [6d 5c 4c] [4d]
Big Blind: bets $0.64 
Dealer: folds
Uncalled bet ($0.64) returned to Big Blind
Big Blind: doesn't show hand
Big Blind collected $0.61 from pot
Table deposit $5 
*** SUMMARY ***
Total pot $0.64 | Rake $0.03
Board [6d 5c 4c 4d]
Seat 1: UTG showed
Seat 2: Hero showed
Seat 3: UTGplus2 showed
Seat 4: Dealer (button) showed
Seat 5: Small Blind (small blind) showed
Seat 6: Big Blind (big blind) won ($0.61)



PokerStars Zoom Hand #3434781004: Hold'em No Limit ($0.02/$0.05) - 2017/03/09 23:55:12
Table '#952' 6-max Seat #5 is the button
Seat 1: Big Blind ($1.55 in chips)
Seat 2: UTG ($8.69 in chips)
Seat 3: UTGplus1 ($6.32 in chips)
Seat 4: UTGplus2 ($9.63 in chips)
Seat 5: Hero ($5 in chips)
Seat 6: Small Blind ($6.14 in chips)
Small Blind: posts small blind $0.02
Big Blind: posts big blind $0.05
*** HOLE CARDS ***
Dealt to Hero [Kc 8h]
UTG: folds
UTGplus1: raises $0.15 to $0.15
UTGplus2: folds
Hero: folds
Small Blind: folds
Big Blind: folds
Uncalled bet ($0.10) returned to UTGplus1
UTGplus1: doesn't show hand
UTGplus1 collected $0.12 from pot
*** SUMMARY ***
Total pot $0.12 | Rake $0.00
Seat 1: Big Blind (big blind) showed
Seat 2: UTG showed
Seat 3: UTGplus1 won ($0.12)
Seat 4: UTGplus2 showed
Seat 5: Hero (button) showed
Seat 6: Small Blind (small blind) showed



PokerStars Zoom Hand #3434781104: Hold'em No Limit ($0.02/$0.05) - 2017/03/09 23:55:26
Table '#952' 6-max Seat #3 is the button
Seat 1: UTGplus1 ($18.34 in chips)
Seat 2: UTGplus2 ($12.18 in chips)
Seat 3: Dealer ($3.46 in chips)
Seat 4: Small Blind ($21.09 in chips)
Seat 5: Hero ($5 in chips)
Seat 6: UTG ($6.43 in chips)
Small Blind: posts small blind $0.02
Hero: posts big blind $0.05
*** HOLE CARDS ***
Dealt to Hero [5h 5d]
UTG: folds
UTGplus1: folds
UTGplus2: folds
Dealer: raises $0.20 to $0.20
Small Blind: folds
Hero: calls $0.15 
*** FLOP *** [Kd Ac 5c]
Hero: checks
Dealer: checks (disconnect)
*** TURN *** [Kd Ac 5c] [6s]
Hero: checks
Dealer: checks (disconnect)
*** RIVER *** [Kd Ac 5c 6s] [Qd]
Hero: checks
Dealer: checks (disconnect)
*** SHOW DOWN ***
Hero: shows [5h 5d] (three of a kind, Fives)
Dealer: shows [5s 8s] (One pair)
Hero collected $0.4 from pot
Table deposit $2.50 
Seat re-join
*** SUMMARY ***
Total pot $0.42 | Rake $0.02
Board [Kd Ac 5c 6s Qd]
Seat 1: UTGplus1 showed
Seat 2: UTGplus2 showed
Seat 3: Dealer (button) showed [5s 8s]
Seat 4: Small Blind (small blind) showed
Seat 5: Hero (big blind) showed [5h 5d] and won ($0.4) with three of a kind, Fives
Seat 6: UTG showed



PokerStars Zoom Hand #3434781449: Hold'em No Limit ($0.02/$0.05) - 2017/03/09 23:56:12
Table '#952' 6-max Seat #4 is the button
Seat 1: UTG ($7.88 in chips)
Seat 2: UTGplus1 ($2.53 in chips)
Seat 3: UTGplus2 ($5.07 in chips)
Seat 4: Hero ($5.20 in chips)
Seat 5: Small Blind ($2.26 in chips)
Seat 6: Big Blind ($4.88 in chips)
Small Blind: posts small blind $0.02
Big Blind: posts big blind $0.05
*** HOLE CARDS ***
Dealt to Hero [4d 7c]
UTG: folds
UTGplus1: raises $0.17 to $0.17
UTGplus2: folds
Hero: folds
Small Blind: folds
Big Blind: folds
Uncalled bet ($0.12) returned to UTGplus1
UTGplus1: doesn't show hand
UTGplus1 collected $0.12 from pot
*** SUMMARY ***
Total pot $0.12 | Rake $0.00
Seat 1: UTG showed
Seat 2: UTGplus1 won ($0.12)
Seat 3: UTGplus2 showed
Seat 4: Hero (button) showed
Seat 5: Small Blind (small blind) showed
Seat 6: Big Blind (big blind) showed



PokerStars Zoom Hand #3434781539: Hold'em No Limit ($0.02/$0.05) - 2017/03/09 23:56:23
Table '#952' 6-max Seat #5 is the button
Seat 1: Big Blind ($20.35 in chips)
Seat 2: UTG ($3.39 in chips)
Seat 3: UTGplus1 ($4.83 in chips)
Seat 4: UTGplus2 ($3.39 in chips)
Seat 5: Dealer ($6.60 in chips)
Seat 6: Hero ($5.20 in chips)
Hero: posts small blind $0.02
Big Blind: posts big blind $0.05
*** HOLE CARDS ***
Dealt to Hero [8s 8c]
UTG: folds
UTGplus1: folds
UTGplus2: folds
Dealer: folds
Hero: raises $0.13 to $0.15
Big Blind: calls $0.10 
*** FLOP *** [Tc Jd 9c]
Hero: bets $0.20 
Big Blind: calls $0.20 
*** TURN *** [Tc Jd 9c] [5c]
Hero: bets $0.50 
Big Blind: folds
Uncalled bet ($0.50) returned to Hero
Hero: doesn't show hand
Hero collected $0.67 from pot
*** SUMMARY ***
Total pot $0.7 | Rake $0.03
Board [Tc Jd 9c 5c]
Seat 1: Big Blind (big blind) showed
Seat 2: UTG showed
Seat 3: UTGplus1 showed
Seat 4: UTGplus2 showed
Seat 5: Dealer (button) showed
Seat 6: Hero (small blind) won ($0.67)



PokerStars Zoom Hand #3434782104: Hold'em No Limit ($0.02/$0.05) - 2017/03/09 23:57:43
Table '#952' 6-max Seat #5 is the button
Seat 1: Hero ($5.52 in chips)
Seat 2: UTG ($2.18 in chips)
Seat 3: UTGplus1 ($20 in chips)
Seat 4: UTGplus2 ($4.85 in chips)
Seat 5: Dealer ($12.17 in chips)
Seat 6: Small Blind ($2.67 in chips)
Small Blind: posts small blind $0.02
Hero: posts big blind $0.05
*** HOLE CARDS ***
Dealt to Hero [3c Kc]
UTG: folds
UTGplus1: folds
UTGplus2: calls $0.05 
Dealer: folds
Small Blind: raises $0.18 to $0.20
Hero: folds
UTGplus2: calls $0.15 
*** FLOP *** [2c Kh 5h]
Small Blind: bets $0.32 
UTGplus2: calls $0.32 
*** TURN *** [2c Kh 5h] [3h]
Small Blind: bets $0.64 
UTGplus2: calls $0.64 
*** RIVER *** [2c Kh 5h 3h] [6s]
Small Blind: bets $1.51 and is all-in
UTGplus2: calls $1.51 
*** SHOW DOWN ***
Small Blind: shows [Ks Ad] (a pair of Kings)
UTGplus2: shows [7h 6h] (a flush, King high)
UTGplus2 collected $5.13 from pot
*** SUMMARY ***
Total pot $5.39 | Rake $0.26
Board [2c Kh 5h 3h 6s]
Seat 1: Hero (big blind) showed
Seat 2: UTG showed
Seat 3: UTGplus1 showed
Seat 4: UTGplus2 showed [7h 6h] and won ($5.13) with a flush, King high
Seat 5: Dealer (button) showed
Seat 6: Small Blind (small blind) showed [Ks Ad] and lost with a pair of Kings



PokerStars Zoom Hand #3434782291: Hold'em No Limit ($0.02/$0.05) - 2017/03/09 23:58:07
Table '#952' 6-max Seat #6 is the button
Seat 1: Small Blind ($7.69 in chips)
Seat 2: Big Blind ($5.06 in chips)
Seat 3: UTG ($5.57 in chips)
Seat 4: UTGplus1 ($6.60 in chips)
Seat 5: UTGplus2 ($8.36 in chips)
Seat 6: Hero ($5.47 in chips)
Small Blind: posts small blind $0.02
Big Blind: posts big blind $0.05
*** HOLE CARDS ***
Dealt to Hero [As 3d]
UTG: raises $0.15 to $0.15
UTGplus1: folds
UTGplus2: calls $0.15 
Hero: folds
Small Blind: folds
Big Blind: folds
*** FLOP *** [6s 7c 9h]
UTG: bets $0.18 
UTGplus2: calls $0.18 
*** TURN *** [6s 7c 9h] [4d]
UTG: checks
UTGplus2: bets $0.35 
UTG: folds
Uncalled bet ($0.35) returned to UTGplus2
UTGplus2: doesn't show hand
UTGplus2 collected $0.7 from pot
*** SUMMARY ***
Total pot $0.73 | Rake $0.03
Board [6s 7c 9h 4d]
Seat 1: Small Blind (small blind) showed
Seat 2: Big Blind (big blind) showed
Seat 3: UTG showed
Seat 4: UTGplus1 showed
Seat 5: UTGplus2 won ($0.7)
Seat 6: Hero (button) showed



PokerStars Zoom Hand #3434782336: Hold'em No Limit ($0.02/$0.05) - 2017/03/09 23:58:13
Table '#952' 6-max Seat #6 is the button
Seat 1: Hero ($5.47 in chips)
Seat 2: Big Blind ($6.60 in chips)
Seat 3: UTG ($7.58 in chips)
Seat 4: UTGplus1 ($4.19 in chips)
Seat 5: UTGplus2 ($7.65 in chips)
Seat 6: Dealer ($8.06 in chips)
Hero: posts small blind $0.02
Big Blind: posts big blind $0.05
*** HOLE CARDS ***
Dealt to Hero [Jh Th]
UTG: folds
UTGplus1: folds
UTGplus2: folds
Dealer: raises $0.15 to $0.15
Hero: calls $0.13 
Big Blind: folds
*** FLOP *** [3c 9s Ts]
Hero: checks
Dealer: bets $0.25 
Hero: calls $0.25 
*** TURN *** [3c 9s Ts] [Kh]
Hero: checks
Dealer: bets $0.47 
Hero: calls $0.47 
*** RIVER *** [3c 9s Ts Kh] [Qc]
Hero: bets $1.79 
Dealer: folds
Uncalled bet ($1.79) returned to Hero
Hero: doesn't show hand
Hero collected $1.71 from pot
*** SUMMARY ***
Total pot $1.79 | Rake $0.08
Board [3c 9s Ts Kh Qc]
Seat 1: Hero (small blind) won ($1.71)
Seat 2: Big Blind (big blind) showed
Seat 3: UTG showed
Seat 4: UTGplus1 showed
Seat 5: UTGplus2 showed
Seat 6: Dealer (button) showed



PokerStars Zoom Hand #3434782904: Hold'em No Limit ($0.02/$0.05) - 2017/03/09 23:59:29
Table '#952' 6-max Seat #5 is the button
Seat 1: Big Blind ($2.79 in chips)
Seat 2: UTG ($3.50 in chips)
Seat 3: Hero ($6.31 in chips)
Seat 4: UTGplus2 ($3.09 in chips)
Seat 5: Dealer ($2.44 in chips)
Seat 6: Small Blind ($7.17 in chips)
Small Blind: posts small blind $0.02
Big Blind: posts big blind $0.05
*** HOLE CARDS ***
Dealt to Hero [2s 7c]
UTG: calls $0.05 
Hero: folds
UTGplus2: folds
Dealer: calls $0.05 
Small Blind: folds
Big Blind: checks
*** FLOP *** [Qh Qc 9h]
Big Blind: checks
UTG: checks
Dealer: bets $0.08 
Big Blind: calls $0.08 
UTG: folds
*** TURN *** [Qh Qc 9h] [Td]
Big Blind: checks
Dealer: checks
*** RIVER *** [Qh Qc 9h Td] [9s]
Big Blind: checks
Dealer: checks
*** SHOW DOWN ***
Big Blind: shows [9d Ks] (a full house, Nines full of Queens)
Dealer: shows [Th Kh] (Two pair)
Big Blind collected $0.32 from pot
*** SUMMARY ***
Total pot $0.33 | Rake $0.01
Board [Qh Qc 9h Td 9s]
Seat 1: Big Blind (big blind) showed [9d Ks] and won ($0.32) with a full house, Nines full of Queens
Seat 2: UTG showed
Seat 3: Hero showed
Seat 4: UTGplus2 showed
Seat 5: Dealer (button) showed [Th Kh]
Seat 6: Small Blind (small blind) showed



PokerStars Zoom Hand #3434782953: Hold'em No Limit ($0.02/$0.05) - 2017/03/09 23:59:36
Table '#952' 6-max Seat #3 is the button
Seat 1: UTGplus1 ($7.62 in chips)
Seat 2: Hero ($6.31 in chips)
Seat 3: Dealer ($11.61 in chips)
Seat 4: Small Blind ($7.98 in chips)
Seat 5: Big Blind ($19.81 in chips)
Seat 6: UTG ($1.55 in chips)
Small Blind: posts small blind $0.02
Big Blind: posts big blind $0.05
*** HOLE CARDS ***
Dealt to Hero [Ts Ac]
UTG: folds
UTGplus1: folds
Hero: raises $0.17 to $0.17
Dealer: folds
Small Blind: folds
Big Blind: folds
Uncalled bet ($0.12) returned to Hero
Hero: doesn't show hand
Hero collected $0.12 from pot
*** SUMMARY ***
Total pot $0.12 | Rake $0.00
Seat 1: UTGplus1 showed
Seat 2: Hero won ($0.12)
Seat 3: Dealer (button) showed
Seat 4: Small Blind (small blind) showed
Seat 5: Big Blind (big blind) showed
Seat 6: UTG showed



PokerStars Zoom Hand #3434783132: Hold'em No Limit ($0.02/$0.05) - 2017/03/10 0:00:01
Table '#952' 6-max Seat #1 is the button
Seat 1: Dealer ($4.28 in chips)
Seat 2: Small Blind ($1.57 in chips)
Seat 3: Hero ($6.38 in chips)
Seat 4: UTG ($5.71 in chips)
Seat 5: UTGplus1 ($9.18 in chips)
Seat 6: UTGplus2 ($7.92 in chips)
Small Blind: posts small blind $0.02
Hero: posts big blind $0.05
*** HOLE CARDS ***
Dealt to Hero [3d 6c]
UTG: folds
UTGplus1: folds
UTGplus2: folds
Dealer: folds
Small Blind: raises $0.13 to $0.15
Hero: folds
Uncalled bet ($0.10) returned to Small Blind
Small Blind: doesn't show hand
Small Blind collected $0.1 from pot
*** SUMMARY ***
Total pot $0.1 | Rake $0.00
Seat 1: Dealer (button) showed
Seat 2: Small Blind (small blind) won ($0.1)
Seat 3: Hero (big blind) showed
Seat 4: UTG showed
Seat 5: UTGplus1 showed
Seat 6: UTGplus2 showed



PokerStars Zoom Hand #3434783288: Hold'em No Limit ($0.02/$0.05) - 2017/03/10 0:00:26
Table '#952' 6-max Seat #5 is the button
Seat 1: Big Blind ($4.26 in chips)
Seat 2: UTG ($12.04 in chips)
Seat 3: UTGplus1 ($9.32 in chips)
Seat 4: UTGplus2 ($4.60 in chips)
Seat 5: Hero ($6.33 in chips)
Seat 6: Small Blind ($18.51 in chips)
Small Blind: posts small blind $0.02
Big Blind: posts big blind $0.05
*** HOLE CARDS ***
Dealt to Hero [6c 5c]
UTG: folds
UTGplus1: folds
UTGplus2: raises $0.15 to $0.15
Hero: calls $0.15 
Small Blind: folds
Big Blind: calls $0.10 
*** FLOP *** [Kc Qh Qd]
Big Blind: checks
UTGplus2: checks
Hero: checks
*** TURN *** [Kc Qh Qd] [9h]
Big Blind: checks
UTGplus2: checks
Hero: checks
*** RIVER *** [Kc Qh Qd 9h] [Tc]
Big Blind: checks
UTGplus2: bets $0.28 
Hero: folds
Big Blind: folds
Uncalled bet ($0.28) returned to UTGplus2
UTGplus2: doesn't show hand
UTGplus2 collected $0.45 from pot
*** SUMMARY ***
Total pot $0.47 | Rake $0.02
Board [Kc Qh Qd 9h Tc]
Seat 1: Big Blind (big blind) showed
Seat 2: UTG showed
Seat 3: UTGplus1 showed
Seat 4: UTGplus2 won ($0.45)
Seat 5: Hero (button) showed
Seat 6: Small Blind (small blind) showed



PokerStars Zoom Hand #3434783762: Hold'em No Limit ($0.02/$0.05) - 2017/03/10 0:01:34
Table '#952' 6-max Seat #6 is the button
Seat 1: Small Blind ($8.28 in chips)
Seat 2: Big Blind ($5.99 in chips)
Seat 3: Hero ($6.18 in chips)
Seat 4: UTGplus1 ($23.04 in chips)
Seat 5: UTGplus2 ($4.47 in chips)
Seat 6: Dealer ($3.07 in chips)
Small Blind: posts small blind $0.02
Big Blind: posts big blind $0.05
*** HOLE CARDS ***
Dealt to Hero [4d Ks]
Hero: folds
UTGplus1: folds
UTGplus2: folds
Dealer: folds
Small Blind: folds
Big Blind: doesn't show hand
Big Blind collected $0.07 from pot
Seat re-join
*** SUMMARY ***
Total pot $0.07 | Rake $0.00
Seat 1: Small Blind (small blind) showed
Seat 2: Big Blind (big blind) won ($0.07)
Seat 3: Hero showed
Seat 4: UTGplus1 showed
Seat 5: UTGplus2 showed
Seat 6: Dealer (button) showed



PokerStars Zoom Hand #3434783801: Hold'em No Limit ($0.02/$0.05) - 2017/03/10 0:01:39
Table '#952' 6-max Seat #5 is the button
Seat 1: Big Blind ($4.17 in chips)
Seat 2: UTG ($8.26 in chips)
Seat 3: UTGplus1 ($7.57 in chips)
Seat 4: Hero ($6.18 in chips)
Seat 5: Dealer ($4.91 in chips)
Seat 6: Small Blind ($5.24 in chips)
Small Blind: posts small blind $0.02
Big Blind: posts big blind $0.05
*** HOLE CARDS ***
Dealt to Hero [7c 9d]
UTG: folds
UTGplus1: folds
Hero: folds
Dealer: raises $0.15 to $0.15
Small Blind: folds
Big Blind: calls $0.10 
*** FLOP *** [Qs Js 5h]
Big Blind: bets $0.20 
Dealer: calls $0.20 
*** TURN *** [Qs Js 5h] [4h]
Big Blind: checks
Dealer: checks
*** RIVER *** [Qs Js 5h 4h] [Kh]
Big Blind: bets $0.30 
Dealer: calls $0.30 
*** SHOW DOWN ***
Big Blind: shows [Ad Ah] (a pair of Aces)
Dealer: shows [8c Ks] (One pair)
Big Blind collected $1.26 from pot
*** SUMMARY ***
Total pot $1.32 | Rake $0.06
Board [Qs Js 5h 4h Kh]
Seat 1: Big Blind (big blind) showed [Ad Ah] and won ($1.26) with a pair of Aces
Seat 2: UTG showed
Seat 3: UTGplus1 showed
Seat 4: Hero showed
Seat 5: Dealer (button) showed [8c Ks]
Seat 6: Small Blind (small blind) showed



PokerStars Zoom Hand #3434783836: Hold'em No Limit ($0.02/$0.05) - 2017/03/10 0:01:43
Table '#952' 6-max Seat #1 is the button
Seat 1: Dealer ($4.91 in chips)
Seat 2: Small Blind ($3.27 in chips)
Seat 3: Big Blind ($8.26 in chips)
Seat 4: UTG ($4.77 in chips)
Seat 5: UTGplus1 ($5.62 in chips)
Seat 6: Hero ($6.18 in chips)
Small Blind: posts small blind $0.02
Big Blind: posts big blind $0.05
*** HOLE CARDS ***
Dealt to Hero [Ah Kd]
UTG: folds
UTGplus1: folds
Hero: raises $0.17 to $0.17
Dealer: folds
Small Blind: folds
Big Blind: calls $0.12 
*** FLOP *** [Kh 3c Ks]
Big Blind: checks
Hero: checks
*** TURN *** [Kh 3c Ks] [Td]
Big Blind: checks
Hero: checks
*** RIVER *** [Kh 3c Ks Td] [5s]
Big Blind: bets $1.57 
Hero: raises $5.07 to $5.07
Big Blind: folds
Uncalled bet ($3.50) returned to Hero
Hero: doesn't show hand
Hero collected $3.33 from pot
Table leave user
*** SUMMARY ***
Total pot $3.5 | Rake $0.17
Board [Kh 3c Ks Td 5s]
Seat 1: Dealer (button) showed
Seat 2: Small Blind (small blind) showed
Seat 3: Big Blind (big blind) showed
Seat 4: UTG showed
Seat 5: UTGplus1 showed
Seat 6: Hero won ($3.33)



PokerStars Zoom Hand #3434784309: Hold'em No Limit ($0.02/$0.05) - 2017/03/10 0:02:47
Table '#952' 6-max Seat #5 is the button
Seat 1: Big Blind ($3.82 in chips)
Seat 2: Hero ($7.77 in chips)
Seat 3: UTGplus1 ($5.10 in chips)
Seat 4: UTGplus2 ($11.81 in chips)
Seat 5: Dealer ($4.69 in chips)
Seat 6: Small Blind ($4.76 in chips)
Small Blind: posts small blind $0.02
Big Blind: posts big blind $0.05
*** HOLE CARDS ***
Dealt to Hero [5d 8h]
Hero: folds
UTGplus1: folds
UTGplus2: raises $0.15 to $0.15
Dealer: folds
Small Blind: folds
Big Blind: folds
Uncalled bet ($0.10) returned to UTGplus2
UTGplus2: doesn't show hand
UTGplus2 collected $0.12 from pot
*** SUMMARY ***
Total pot $0.12 | Rake $0.00
Seat 1: Big Blind (big blind) showed
Seat 2: Hero showed
Seat 3: UTGplus1 showed
Seat 4: UTGplus2 won ($0.12)
Seat 5: Dealer (button) showed
Seat 6: Small Blind (small blind) showed



PokerStars Zoom Hand #3434784367: Hold'em No Limit ($0.02/$0.05) - 2017/03/10 0:02:54
Table '#952' 6-max Seat #1 is the button
Seat 1: Dealer ($7.69 in chips)
Seat 2: Small Blind ($5.20 in chips)
Seat 3: Big Blind ($8.95 in chips)
Seat 4: UTG ($6.14 in chips)
Seat 5: UTGplus1 ($11.31 in chips)
Seat 6: Hero ($7.77 in chips)
Small Blind: posts small blind $0.02
Big Blind: posts big blind $0.05
*** HOLE CARDS ***
Dealt to Hero [4d 3d]
UTG: folds
UTGplus1: folds
Hero: folds
Dealer: folds
Small Blind: raises $0.13 to $0.15
Big Blind: folds
Uncalled bet ($0.10) returned to Small Blind
Small Blind: doesn't show hand
Small Blind collected $0.1 from pot
Table deposit $5 
*** SUMMARY ***
Total pot $0.1 | Rake $0.00
Seat 1: Dealer (button) showed
Seat 2: Small Blind (small blind) won ($0.1)
Seat 3: Big Blind (big blind) showed
Seat 4: UTG showed
Seat 5: UTGplus1 showed
Seat 6: Hero showed



PokerStars Zoom Hand #3434784532: Hold'em No Limit ($0.02/$0.05) - 2017/03/10 0:03:16
Table '#952' 6-max Seat #1 is the button
Seat 1: Dealer ($1.53 in chips)
Seat 2: Small Blind ($5.87 in chips)
Seat 3: Hero ($7.77 in chips)
Seat 4: UTG ($5.42 in chips)
Seat 5: UTGplus1 ($6.59 in chips)
Seat 6: UTGplus2 ($2.15 in chips)
Small Blind: posts small blind $0.02
Hero: posts big blind $0.05
*** HOLE CARDS ***
Dealt to Hero [4s 4c]
UTG: folds
UTGplus1: folds
UTGplus2: raises $0.15 to $0.15
Dealer: folds
Small Blind: folds
Hero: calls $0.10 
*** FLOP *** [6c 8s Ts]
Hero: checks
UTGplus2: bets $0.32 
Hero: folds
Uncalled bet ($0.32) returned to UTGplus2
UTGplus2: doesn't show hand
UTGplus2 collected $0.31 from pot
Table deposit $5 
*** SUMMARY ***
Total pot $0.32 | Rake $0.01
Board [6c 8s Ts]
Seat 1: Dealer (button) showed
Seat 2: Small Blind (small blind) showed
Seat 3: Hero (big blind) showed
Seat 4: UTG showed
Seat 5: UTGplus1 showed
Seat 6: UTGplus2 won ($0.31)



PokerStars Zoom Hand #3434784750: Hold'em No Limit ($0.02/$0.05) - 2017/03/10 0:03:46
Table '#952' 6-max Seat #5 is the button
Seat 1: Big Blind ($24.67 in chips)
Seat 2: UTG ($4.91 in chips)
Seat 3: UTGplus1 ($12.07 in chips)
Seat 4: UTGplus2 ($4.80 in chips)
Seat 5: Dealer ($5.05 in chips)
Seat 6: Hero ($7.62 in chips)
Hero: posts small blind $0.02
Big Blind: posts big blind $0.05
*** HOLE CARDS ***
Dealt to Hero [Qd 9s]
UTG: folds
UTGplus1: folds
UTGplus2: folds
Dealer: folds
Hero: folds
Big Blind: doesn't show hand
Big Blind collected $0.07 from pot
Table leave user
*** SUMMARY ***
Total pot $0.07 | Rake $0.00
Seat 1: Big Blind (big blind) won ($0.07)
Seat 2: UTG showed
Seat 3: UTGplus1 showed
Seat 4: UTGplus2 showed
Seat 5: Dealer (button) showed
Seat 6: Hero (small blind) showed



PokerStars Zoom Hand #3434784786: Hold'em No Limit ($0.02/$0.05) - 2017/03/10 0:03:52
Table '#952' 6-max Seat #1 is the button
Seat 1: Dealer ($17.94 in chips)
Seat 2: Small Blind ($4.21 in chips)
Seat 3: Big Blind ($5 in chips)
Seat 4: UTG ($16.79 in chips)
Seat 5: UTGplus1 ($4.72 in chips)
Seat 6: Hero ($7.60 in chips)
Small Blind: posts small blind $0.02
Big Blind: posts big blind $0.05
*** HOLE CARDS ***
Dealt to Hero [2c Ac]
UTG: calls $0.05 
UTGplus1: folds
Hero: calls $0.05 
Dealer: raises $0.25 to $0.25
Small Blind: folds
Big Blind: raises $0.75 to $0.80
UTG: folds
Hero: folds
Dealer: raises $1.55 to $1.80
Big Blind: calls $1 
*** FLOP *** [4s 3c 4h]
Big Blind: checks
Dealer: bets $16.14 and is all-in
Big Blind: folds
Uncalled bet ($16.14) returned to Dealer
Dealer: doesn't show hand
Dealer collected $3.54 from pot
Table leave user
Table deposit $5 
*** SUMMARY ***
Total pot $3.72 | Rake $0.18
Board [4s 3c 4h]
Seat 1: Dealer (button) won ($3.54)
Seat 2: Small Blind (small blind) showed
Seat 3: Big Blind (big blind) showed
Seat 4: UTG showed
Seat 5: UTGplus1 showed
Seat 6: Hero showed



PokerStars Zoom Hand #3434784945: Hold'em No Limit ($0.02/$0.05) - 2017/03/10 0:04:13
Table '#952' 6-max Seat #5 is the button
Seat 1: Big Blind ($2.75 in chips)
Seat 2: UTG ($4.82 in chips)
Seat 3: UTGplus1 ($6.86 in chips)
Seat 4: UTGplus2 ($3.19 in chips)
Seat 5: Dealer ($9 in chips)
Seat 6: Hero ($7.55 in chips)
Hero: posts small blind $0.02
Big Blind: posts big blind $0.05
*** HOLE CARDS ***
Dealt to Hero [4d Ks]
UTG: folds
UTGplus1: folds
UTGplus2: folds 
Dealer: folds
Hero: folds
Big Blind: doesn't show hand
Big Blind collected $0.07 from pot
Table deposit $1.51 
*** SUMMARY ***
Total pot $0.07 | Rake $0.00
Seat 1: Big Blind (big blind) won ($0.07)
Seat 2: UTG showed
Seat 3: UTGplus1 showed
Seat 4: UTGplus2 showed
Seat 5: Dealer (button) showed
Seat 6: Hero (small blind) showed



PokerStars Zoom Hand #3434784997: Hold'em No Limit ($0.02/$0.05) - 2017/03/10 0:04:20
Table '#952' 6-max Seat #5 is the button
Seat 1: Big Blind ($15.66 in chips)
Seat 2: UTG ($7.48 in chips)
Seat 3: UTGplus1 ($4.82 in chips)
Seat 4: UTGplus2 ($8.35 in chips)
Seat 5: Hero ($7.53 in chips)
Seat 6: Small Blind ($6.31 in chips)
Small Blind: posts small blind $0.02
Big Blind: posts big blind $0.05
*** HOLE CARDS ***
Dealt to Hero [3h 3d]
UTG: folds
UTGplus1: folds
UTGplus2: folds
Hero: raises $0.17 to $0.17
Small Blind: calls $0.15 
Big Blind: folds
*** FLOP *** [4s Ad Kd]
Small Blind: checks
Hero: bets $0.24 
Small Blind: calls $0.24 
*** TURN *** [4s Ad Kd] [7h]
Small Blind: checks
Hero: checks
*** RIVER *** [4s Ad Kd 7h] [7s]
Small Blind: bets $0.45 
Hero: folds
Uncalled bet ($0.45) returned to Small Blind
Small Blind: doesn't show hand
Small Blind collected $0.83 from pot
*** SUMMARY ***
Total pot $0.87 | Rake $0.04
Board [4s Ad Kd 7h 7s]
Seat 1: Big Blind (big blind) showed
Seat 2: UTG showed
Seat 3: UTGplus1 showed
Seat 4: UTGplus2 showed
Seat 5: Hero (button) showed
Seat 6: Small Blind (small blind) won ($0.83)



PokerStars Zoom Hand #3434785271: Hold'em No Limit ($0.02/$0.05) - 2017/03/10 0:04:59
Table '#952' 6-max Seat #5 is the button
Seat 1: Big Blind ($4.09 in chips)
Seat 2: UTG ($5.36 in chips)
Seat 3: UTGplus1 ($4.90 in chips)
Seat 4: UTGplus2 ($6.76 in chips)
Seat 5: Hero ($7.12 in chips)
Seat 6: Small Blind ($5.07 in chips)
Small Blind: posts small blind $0.02
Big Blind: posts big blind $0.05
*** HOLE CARDS ***
Dealt to Hero [Kh 5h]
UTG: folds
UTGplus1: folds
UTGplus2: folds
Hero: raises $0.17 to $0.17
Small Blind: folds
Big Blind: folds
Uncalled bet ($0.12) returned to Hero
Hero: doesn't show hand
Hero collected $0.12 from pot
*** SUMMARY ***
Total pot $0.12 | Rake $0.00
Seat 1: Big Blind (big blind) showed
Seat 2: UTG showed
Seat 3: UTGplus1 showed
Seat 4: UTGplus2 showed
Seat 5: Hero (button) won ($0.12)
Seat 6: Small Blind (small blind) showed



PokerStars Zoom Hand #3434785446: Hold'em No Limit ($0.02/$0.05) - 2017/03/10 0:05:24
Table '#952' 6-max Seat #3 is the button
Seat 1: UTGplus1 ($2.50 in chips)
Seat 2: UTGplus2 ($5.29 in chips)
Seat 3: Dealer ($2.82 in chips)
Seat 4: Small Blind ($16.81 in chips)
Seat 5: Hero ($7.19 in chips)
Seat 6: UTG ($6.35 in chips)
Small Blind: posts small blind $0.02
Hero: posts big blind $0.05
*** HOLE CARDS ***
Dealt to Hero [Ah 6d]
UTG: folds
UTGplus1: folds
UTGplus2: calls $0.05 
Dealer: raises $0.15 to $0.15
Small Blind: calls $0.13 
Hero: calls $0.10 
UTGplus2: calls $0.10 
*** FLOP *** [Qh 4s 9s]
Small Blind: checks
Hero: checks
UTGplus2: checks
Dealer: bets $0.20 
Small Blind: folds
Hero: folds
UTGplus2: calls $0.20 
*** TURN *** [Qh 4s 9s] [Jc]
UTGplus2: checks
Dealer: checks
*** RIVER *** [Qh 4s 9s Jc] [Jd]
UTGplus2: checks
Dealer: checks
*** SHOW DOWN ***
UTGplus2: shows [Th Tc] (two pair, Jacks and Queens)
Dealer: shows [9c 7c] (Two pair)
UTGplus2 collected $0.95 from pot
Table leave user
*** SUMMARY ***
Total pot $1 | Rake $0.05
Board [Qh 4s 9s Jc Jd]
Seat 1: UTGplus1 showed
Seat 2: UTGplus2 showed [Th Tc] and won ($0.95) with two pair, Jacks and Queens
Seat 3: Dealer (button) showed [9c 7c]
Seat 4: Small Blind (small blind) showed
Seat 5: Hero (big blind) showed
Seat 6: UTG showed



PokerStars Zoom Hand #3434785667: Hold'em No Limit ($0.02/$0.05) - 2017/03/10 0:05:52
Table '#952' 6-max Seat #4 is the button
Seat 1: UTG ($6.86 in chips)
Seat 2: UTGplus1 ($5.60 in chips)
Seat 3: UTGplus2 ($3.36 in chips)
Seat 4: Dealer ($6.18 in chips)
Seat 5: Hero ($7.04 in chips)
Seat 6: Big Blind ($4.90 in chips)
Hero: posts small blind $0.02
Big Blind: posts big blind $0.05
*** HOLE CARDS ***
Dealt to Hero [Ac 5d]
UTG: folds
UTGplus1: folds
UTGplus2: folds
Dealer: folds
Hero: folds
Big Blind: doesn't show hand
Big Blind collected $0.07 from pot
*** SUMMARY ***
Total pot $0.07 | Rake $0.00
Seat 1: UTG showed
Seat 2: UTGplus1 showed
Seat 3: UTGplus2 showed
Seat 4: Dealer (button) showed
Seat 5: Hero (small blind) showed
Seat 6: Big Blind (big blind) won ($0.07)



PokerStars Zoom Hand #3434785701: Hold'em No Limit ($0.02/$0.05) - 2017/03/10 0:05:57
Table '#952' 6-max Seat #2 is the button
Seat 1: UTGplus2 ($5.60 in chips)
Seat 2: Dealer ($2.45 in chips)
Seat 3: Small Blind ($4.87 in chips)
Seat 4: Big Blind ($11.36 in chips)
Seat 5: UTG ($6.86 in chips)
Seat 6: Hero ($7.02 in chips)
Small Blind: posts small blind $0.02
Big Blind: posts big blind $0.05
*** HOLE CARDS ***
Dealt to Hero [4d 4c]
UTG: raises $0.20 to $0.20
Hero: calls $0.20 
UTGplus2: calls $0.20 
Dealer: folds
Small Blind: folds
Big Blind: folds
*** FLOP *** [4s 6d 6h]
UTG: bets $0.45 
Hero: calls $0.45 
UTGplus2: folds
*** TURN *** [4s 6d 6h] [Qh]
UTG: bets $0.83 
Hero: calls $0.83 
*** RIVER *** [4s 6d 6h Qh] [4h]
UTG: bets $1.81 
Hero: raises $3.73 to $5.54 and is all-in
UTG: folds
Uncalled bet ($3.73) returned to Hero
Hero: doesn't show hand
Hero collected $6.51 from pot
*** SUMMARY ***
Total pot $6.85 | Rake $0.34
Board [4s 6d 6h Qh 4h]
Seat 1: UTGplus2 showed
Seat 2: Dealer (button) showed
Seat 3: Small Blind (small blind) showed
Seat 4: Big Blind (big blind) showed
Seat 5: UTG showed
Seat 6: Hero won ($6.51)



PokerStars Zoom Hand #3434786330: Hold'em No Limit ($0.02/$0.05) - 2017/03/10 0:07:25
Table '#952' 6-max Seat #3 is the button
Seat 1: UTGplus1 ($4.64 in chips)
Seat 2: UTGplus2 ($4.38 in chips)
Seat 3: Dealer ($2.12 in chips)
Seat 4: Hero ($10.24 in chips)
Seat 5: Big Blind ($1.65 in chips)
Seat 6: UTG ($8.50 in chips)
Hero: posts small blind $0.02
Big Blind: posts big blind $0.05
*** HOLE CARDS ***
Dealt to Hero [6c 8c]
UTG: folds
UTGplus1: folds
UTGplus2: folds
Dealer: folds
Hero: raises $0.13 to $0.15
Big Blind: raises $0.55 to $0.60
Hero: folds
Uncalled bet ($0.45) returned to Big Blind
Big Blind: doesn't show hand
Big Blind collected $0.3 from pot
*** SUMMARY ***
Total pot $0.3 | Rake $0.00
Seat 1: UTGplus1 showed
Seat 2: UTGplus2 showed
Seat 3: Dealer (button) showed
Seat 4: Hero (small blind) showed
Seat 5: Big Blind (big blind) won ($0.3)
Seat 6: UTG showed



PokerStars Zoom Hand #3434786555: Hold'em No Limit ($0.02/$0.05) - 2017/03/10 0:07:55
Table '#952' 6-max Seat #3 is the button
Seat 1: UTGplus1 ($5 in chips)
Seat 2: Hero ($10.09 in chips)
Seat 3: Dealer ($9.15 in chips)
Seat 4: Small Blind ($4.80 in chips)
Seat 5: Big Blind ($3.23 in chips)
Seat 6: UTG ($0.87 in chips)
Small Blind: posts small blind $0.02
Big Blind: posts big blind $0.05
*** HOLE CARDS ***
Dealt to Hero [5c 4c]
UTG: raises $0.15 to $0.15
UTGplus1: folds
Hero: calls $0.15 
Dealer: folds
Small Blind: folds
Big Blind: calls $0.10 
*** FLOP *** [3s 4d 4s]
Big Blind: checks
UTG: bets $0.47 
Hero: calls $0.47 
Big Blind: folds
*** TURN *** [3s 4d 4s] [7d]
UTG: checks 
Hero: bets $1.41 
UTG: calls $0.25 and is all-in
*** RIVER *** [3s 4d 4s 7d] [Th]
*** SHOW DOWN ***
Hero: shows [5c 4c] (three of a kind, Fours)
UTG: shows [Ts 9s] (two pair, Tens and Nines)
Uncalled bet ($1.16) returned to Hero
Hero collected $1.82 from pot
*** SUMMARY ***
Total pot $1.91 | Rake $0.09
Board [3s 4d 4s 7d Th]
Seat 1: UTGplus1 showed
Seat 2: Hero showed [5c 4c] and won ($1.82) with three of a kind, Tens
Seat 3: Dealer (button) showed
Seat 4: Small Blind (small blind) showed
Seat 5: Big Blind (big blind) showed
Seat 6: UTG showed [Ts 9s] and lost with two pair, Tens and Nines



PokerStars Zoom Hand #3434787177: Hold'em No Limit ($0.02/$0.05) - 2017/03/10 0:09:19
Table '#952' 6-max Seat #3 is the button
Seat 1: UTGplus1 ($6.95 in chips)
Seat 2: UTGplus2 ($5.53 in chips)
Seat 3: Dealer ($3.29 in chips)
Seat 4: Small Blind ($4.85 in chips)
Seat 5: Big Blind ($8.48 in chips)
Seat 6: Hero ($11.04 in chips)
Small Blind: posts small blind $0.02
Big Blind: posts big blind $0.05
*** HOLE CARDS ***
Dealt to Hero [Ad 2s]
Hero: folds
UTGplus1: raises $0.15 to $0.15
UTGplus2: folds
Dealer: folds
Small Blind: raises $0.23 to $0.25
Big Blind: calls $0.20 
UTGplus1: calls $0.10 
*** FLOP *** [Qd 6s Td]
Small Blind: checks
Big Blind: checks
UTGplus1: bets $0.52 
Small Blind: raises $1.04 to $1.04
Big Blind: calls $1.04 
UTGplus1: calls $0.52 
*** TURN *** [Qd 6s Td] [2c]
Small Blind: bets $2.01 
Big Blind: folds
UTGplus1: calls $2.01 
*** RIVER *** [Qd 6s Td 2c] [9d]
Small Blind: checks
UTGplus1: checks
*** SHOW DOWN ***
Small Blind: shows [Ks Qc] (a pair of Queens)
UTGplus1: shows [Kc Qs] (a pair of Queens)
UTGplus1 collected $3.75 from pot
Small Blind collected $3.75 from pot
*** SUMMARY ***
Total pot $7.89 | Rake $0.39
Board [Qd 6s Td 2c 9d]
Seat 1: UTGplus1 showed [Kc Qs] and won ($3.75) with a pair of Queens
Seat 2: UTGplus2 showed
Seat 3: Dealer (button) showed
Seat 4: Small Blind (small blind) showed [Ks Qc] and won ($3.75) with a pair of Queens
Seat 5: Big Blind (big blind) showed
Seat 6: Hero showed



PokerStars Zoom Hand #3434787223: Hold'em No Limit ($0.02/$0.05) - 2017/03/10 0:09:25
Table '#952' 6-max Seat #6 is the button
Seat 1: Small Blind ($22.63 in chips)
Seat 2: Hero ($11.04 in chips)
Seat 3: UTG ($3.29 in chips)
Seat 4: UTGplus1 ($2.67 in chips)
Seat 5: UTGplus2 ($3.94 in chips)
Seat 6: Dealer ($7.66 in chips)
Small Blind: posts small blind $0.02
Hero: posts big blind $0.05
*** HOLE CARDS ***
Dealt to Hero [Qh 7d]
UTG: folds
UTGplus1: folds
UTGplus2: folds
Dealer: raises $0.17 to $0.17
Small Blind: folds
Hero: folds
Uncalled bet ($0.12) returned to Dealer
Dealer: doesn't show hand
Dealer collected $0.12 from pot
*** SUMMARY ***
Total pot $0.12 | Rake $0.00
Seat 1: Small Blind (small blind) showed
Seat 2: Hero (big blind) showed
Seat 3: UTG showed
Seat 4: UTGplus1 showed
Seat 5: UTGplus2 showed
Seat 6: Dealer (button) won ($0.12)



PokerStars Zoom Hand #3434787279: Hold'em No Limit ($0.02/$0.05) - 2017/03/10 0:09:32
Table '#952' 6-max Seat #1 is the button
Seat 1: Dealer ($1.95 in chips)
Seat 2: Small Blind ($1.78 in chips)
Seat 3: Big Blind ($5.27 in chips)
Seat 4: UTG ($7.53 in chips)
Seat 5: UTGplus1 ($8.15 in chips)
Seat 6: Hero ($10.99 in chips)
Small Blind: posts small blind $0.02
Big Blind: posts big blind $0.05
*** HOLE CARDS ***
Dealt to Hero [2c 6d]
UTG: folds
UTGplus1: raises $0.10 to $0.10
Hero: folds
Dealer: folds
Small Blind: folds
Big Blind: folds
Uncalled bet ($0.05) returned to UTGplus1
UTGplus1: doesn't show hand
UTGplus1 collected $0.12 from pot
*** SUMMARY ***
Total pot $0.12 | Rake $0.00
Seat 1: Dealer (button) showed
Seat 2: Small Blind (small blind) showed
Seat 3: Big Blind (big blind) showed
Seat 4: UTG showed
Seat 5: UTGplus1 won ($0.12)
Seat 6: Hero showed



PokerStars Zoom Hand #3434787316: Hold'em No Limit ($0.02/$0.05) - 2017/03/10 0:09:37
Table '#952' 6-max Seat #3 is the button
Seat 1: UTGplus1 ($2.78 in chips)
Seat 2: UTGplus2 ($6.20 in chips)
Seat 3: Dealer ($8.99 in chips)
Seat 4: Hero ($10.99 in chips)
Seat 5: Big Blind ($5 in chips)
Seat 6: UTG ($1.76 in chips)
Hero: posts small blind $0.02
Big Blind: posts big blind $0.05
*** HOLE CARDS ***
Dealt to Hero [5d Ts]
UTG: folds
UTGplus1: raises $0.15 to $0.15
UTGplus2: folds
Dealer: folds
Hero: folds
Big Blind: folds
Uncalled bet ($0.10) returned to UTGplus1
UTGplus1: doesn't show hand
UTGplus1 collected $0.12 from pot
Table deposit $4.90 
*** SUMMARY ***
Total pot $0.12 | Rake $0.00
Seat 1: UTGplus1 won ($0.12)
Seat 2: UTGplus2 showed
Seat 3: Dealer (button) showed
Seat 4: Hero (small blind) showed
Seat 5: Big Blind (big blind) showed
Seat 6: UTG showed



PokerStars Zoom Hand #3434787369: Hold'em No Limit ($0.02/$0.05) - 2017/03/10 0:09:45
Table '#952' 6-max Seat #4 is the button
Seat 1: UTG ($1.76 in chips)
Seat 2: UTGplus1 ($15.03 in chips)
Seat 3: Hero ($10.97 in chips)
Seat 4: Dealer ($3.88 in chips)
Seat 5: Small Blind ($11.97 in chips)
Seat 6: Big Blind ($5.25 in chips)
Small Blind: posts small blind $0.02
Big Blind: posts big blind $0.05
*** HOLE CARDS ***
Dealt to Hero [5d 7h]
UTG: folds
UTGplus1: folds
Hero: folds
Dealer: folds
Small Blind: raises $0.13 to $0.15
Big Blind: folds
Uncalled bet ($0.10) returned to Small Blind
Small Blind: doesn't show hand
Small Blind collected $0.1 from pot
*** SUMMARY ***
Total pot $0.1 | Rake $0.00
Seat 1: UTG showed
Seat 2: UTGplus1 showed
Seat 3: Hero showed
Seat 4: Dealer (button) showed
Seat 5: Small Blind (small blind) won ($0.1)
Seat 6: Big Blind (big blind) showed



PokerStars Zoom Hand #3434787416: Hold'em No Limit ($0.02/$0.05) - 2017/03/10 0:09:51
Table '#952' 6-max Seat #3 is the button
Seat 1: Hero ($10.97 in chips)
Seat 2: UTGplus2 ($3.88 in chips)
Seat 3: Dealer ($4.95 in chips)
Seat 4: Small Blind ($5.02 in chips)
Seat 5: Big Blind ($8.39 in chips)
Seat 6: UTG ($2.57 in chips)
Small Blind: posts small blind $0.02
Big Blind: posts big blind $0.05
*** HOLE CARDS ***
Dealt to Hero [8c Qs]
UTG: folds
Hero: folds
UTGplus2: calls $0.05 
Dealer: raises $0.22 to $0.22
Small Blind: raises $0.72 to $0.74
Big Blind: folds
UTGplus2: folds
Dealer: raises $4.21 to $4.95 and is all-in
Small Blind: folds
Uncalled bet ($4.21) returned to Dealer
Dealer: doesn't show hand
Dealer collected $1.58 from pot
*** SUMMARY ***
Total pot $1.58 | Rake $0.00
Seat 1: Hero showed
Seat 2: UTGplus2 showed
Seat 3: Dealer (button) won ($1.58)
Seat 4: Small Blind (small blind) showed
Seat 5: Big Blind (big blind) showed
Seat 6: UTG showed



PokerStars Zoom Hand #3434787466: Hold'em No Limit ($0.02/$0.05) - 2017/03/10 0:09:57
Table '#952' 6-max Seat #6 is the button
Seat 1: Hero ($10.97 in chips)
Seat 2: Big Blind ($4.90 in chips)
Seat 3: UTG ($4.55 in chips)
Seat 4: UTGplus1 ($8.22 in chips)
Seat 5: UTGplus2 ($2.57 in chips)
Seat 6: Dealer ($1.78 in chips)
Hero: posts small blind $0.02
Big Blind: posts big blind $0.05
*** HOLE CARDS ***
Dealt to Hero [Ks 8d]
UTG: folds
UTGplus1: folds
UTGplus2: folds
Dealer: raises $0.15 to $0.15
Hero: folds
Big Blind: folds
Uncalled bet ($0.10) returned to Dealer
Dealer: doesn't show hand
Dealer collected $0.12 from pot
*** SUMMARY ***
Total pot $0.12 | Rake $0.00
Seat 1: Hero (small blind) showed
Seat 2: Big Blind (big blind) showed
Seat 3: UTG showed
Seat 4: UTGplus1 showed
Seat 5: UTGplus2 showed
Seat 6: Dealer (button) won ($0.12)



PokerStars Zoom Hand #3434787505: Hold'em No Limit ($0.02/$0.05) - 2017/03/10 0:10:02
Table '#952' 6-max Seat #6 is the button
Seat 1: Small Blind ($5.67 in chips)
Seat 2: Hero ($10.95 in chips)
Seat 3: UTG ($6.97 in chips)
Seat 4: UTGplus1 ($3.36 in chips)
Seat 5: UTGplus2 ($3.08 in chips)
Seat 6: Dealer ($12.19 in chips)
Small Blind: posts small blind $0.02
Hero: posts big blind $0.05
*** HOLE CARDS ***
Dealt to Hero [9c 3s]
UTG: folds
UTGplus1: folds
UTGplus2: folds
Dealer: raises $0.15 to $0.15
Small Blind: raises $0.43 to $0.45
Hero: folds
Dealer: calls $0.30 
*** FLOP *** [Qd Qs 7d]
Small Blind: bets $0.62 
Dealer: calls $0.62 
*** TURN *** [Qd Qs 7d] [5s]
Small Blind: checks
Dealer: checks
*** RIVER *** [Qd Qs 7d 5s] [5d]
Small Blind: checks
Dealer: bets $0.45 
Small Blind: folds
Uncalled bet ($0.45) returned to Dealer
Dealer: doesn't show hand
Dealer collected $2.09 from pot
*** SUMMARY ***
Total pot $2.19 | Rake $0.10
Board [Qd Qs 7d 5s 5d]
Seat 1: Small Blind (small blind) showed
Seat 2: Hero (big blind) showed
Seat 3: UTG showed
Seat 4: UTGplus1 showed
Seat 5: UTGplus2 showed
Seat 6: Dealer (button) won ($2.09)



PokerStars Zoom Hand #3434787541: Hold'em No Limit ($0.02/$0.05) - 2017/03/10 0:10:07
Table '#952' 6-max Seat #1 is the button
Seat 1: Dealer ($9.06 in chips)
Seat 2: Small Blind ($4.70 in chips)
Seat 3: Big Blind ($8.22 in chips)
Seat 4: UTG ($1.96 in chips)
Seat 5: Hero ($10.90 in chips)
Seat 6: UTGplus2 ($5 in chips)
Small Blind: posts small blind $0.02
Big Blind: posts big blind $0.05
*** HOLE CARDS ***
Dealt to Hero [6s Jc]
UTG: folds
Hero: folds
UTGplus2: raises $0.15 to $0.15
Dealer: folds
Small Blind: folds
Big Blind: folds
Uncalled bet ($0.10) returned to UTGplus2
UTGplus2: doesn't show hand
UTGplus2 collected $0.12 from pot
*** SUMMARY ***
Total pot $0.12 | Rake $0.00
Seat 1: Dealer (button) showed
Seat 2: Small Blind (small blind) showed
Seat 3: Big Blind (big blind) showed
Seat 4: UTG showed
Seat 5: Hero showed
Seat 6: UTGplus2 won ($0.12)



PokerStars Zoom Hand #3434787590: Hold'em No Limit ($0.02/$0.05) - 2017/03/10 0:10:13
Table '#952' 6-max Seat #6 is the button
Seat 1: Small Blind ($8.34 in chips)
Seat 2: Big Blind ($5.35 in chips)
Seat 3: Hero ($10.90 in chips)
Seat 4: UTGplus1 ($6.75 in chips)
Seat 5: UTGplus2 ($4.98 in chips)
Seat 6: Dealer ($14.57 in chips)
Small Blind: posts small blind $0.02
Big Blind: posts big blind $0.05
*** HOLE CARDS ***
Dealt to Hero [4h Kh]
Hero: folds
UTGplus1: folds
UTGplus2: folds
Dealer: raises $0.15 to $0.15
Small Blind: folds
Big Blind: calls $0.10 
*** FLOP *** [9h 5d Qd]
Big Blind: checks
Dealer: bets $0.16 
Big Blind: folds
Uncalled bet ($0.16) returned to Dealer
Dealer: doesn't show hand
Dealer collected $0.31 from pot
*** SUMMARY ***
Total pot $0.32 | Rake $0.01
Board [9h 5d Qd]
Seat 1: Small Blind (small blind) showed
Seat 2: Big Blind (big blind) showed
Seat 3: Hero showed
Seat 4: UTGplus1 showed
Seat 5: UTGplus2 showed
Seat 6: Dealer (button) won ($0.31)



PokerStars Zoom Hand #3434787635: Hold'em No Limit ($0.02/$0.05) - 2017/03/10 0:10:19
Table '#952' 6-max Seat #5 is the button
Seat 1: Big Blind ($6.75 in chips)
Seat 2: UTG ($5 in chips)
Seat 3: Hero ($10.90 in chips)
Seat 4: UTGplus2 ($9.18 in chips)
Seat 5: Dealer ($1.97 in chips)
Seat 6: Small Blind ($8.32 in chips)
Small Blind: posts small blind $0.02
Big Blind: posts big blind $0.05
*** HOLE CARDS ***
Dealt to Hero [Ah 9s]
UTG: folds 
Hero: folds
UTGplus2: folds
Dealer: folds
Small Blind: folds
Big Blind: doesn't show hand
Big Blind collected $0.07 from pot
*** SUMMARY ***
Total pot $0.07 | Rake $0.00
Seat 1: Big Blind (big blind) won ($0.07)
Seat 2: UTG showed
Seat 3: Hero showed
Seat 4: UTGplus2 showed
Seat 5: Dealer (button) showed
Seat 6: Small Blind (small blind) showed



PokerStars Zoom Hand #3434787676: Hold'em No Limit ($0.02/$0.05) - 2017/03/10 0:10:24
Table '#952' 6-max Seat #6 is the button
Seat 1: Small Blind ($7.18 in chips)
Seat 2: Big Blind ($7.40 in chips)
Seat 3: UTG ($5.30 in chips)
Seat 4: UTGplus1 ($12.02 in chips)
Seat 5: UTGplus2 ($4.68 in chips)
Seat 6: Hero ($10.90 in chips)
Small Blind: posts small blind $0.02
Big Blind: posts big blind $0.05
*** HOLE CARDS ***
Dealt to Hero [Ad 5d]
UTG: folds
UTGplus1: folds
UTGplus2: folds
Hero: raises $0.17 to $0.17
Small Blind: folds
Big Blind: calls $0.12 
*** FLOP *** [4s 5s Kc]
Big Blind: checks
Hero: bets $0.23 
Big Blind: folds
Uncalled bet ($0.23) returned to Hero
Hero: doesn't show hand
Hero collected $0.35 from pot
*** SUMMARY ***
Total pot $0.36 | Rake $0.01
Board [4s 5s Kc]
Seat 1: Small Blind (small blind) showed
Seat 2: Big Blind (big blind) showed
Seat 3: UTG showed
Seat 4: UTGplus1 showed
Seat 5: UTGplus2 showed
Seat 6: Hero (button) won ($0.35)



PokerStars Zoom Hand #3434788014: Hold'em No Limit ($0.02/$0.05) - 2017/03/10 0:11:07
Table '#952' 6-max Seat #5 is the button
Seat 1: Big Blind ($2.13 in chips)
Seat 2: UTG ($4.85 in chips)
Seat 3: UTGplus1 ($3.12 in chips)
Seat 4: Hero ($11.08 in chips)
Seat 5: Dealer ($4.10 in chips)
Seat 6: Small Blind ($5.20 in chips)
Small Blind: posts small blind $0.02
Big Blind: posts big blind $0.05
*** HOLE CARDS ***
Dealt to Hero [As Ah]
UTG: folds
UTGplus1: folds
Hero: raises $0.17 to $0.17
Dealer: folds
Small Blind: folds
Big Blind: folds
Uncalled bet ($0.12) returned to Hero
Hero: doesn't show hand
Hero collected $0.12 from pot
*** SUMMARY ***
Total pot $0.12 | Rake $0.00
Seat 1: Big Blind (big blind) showed
Seat 2: UTG showed
Seat 3: UTGplus1 showed
Seat 4: Hero won ($0.12)
Seat 5: Dealer (button) showed
Seat 6: Small Blind (small blind) showed



PokerStars Zoom Hand #3434788217: Hold'em No Limit ($0.02/$0.05) - 2017/03/10 0:11:35
Table '#952' 6-max Seat #1 is the button
Seat 1: Dealer ($7.56 in chips)
Seat 2: Small Blind ($6.35 in chips)
Seat 3: Hero ($11.15 in chips)
Seat 4: UTG ($5.54 in chips)
Seat 5: UTGplus1 ($3.29 in chips)
Seat 6: UTGplus2 ($2.08 in chips)
Small Blind: posts small blind $0.02
Hero: posts big blind $0.05
*** HOLE CARDS ***
Dealt to Hero [Js Th]
UTG: folds
UTGplus1: folds
UTGplus2: folds
Dealer: folds
Small Blind: raises $0.08 to $0.10
Hero: calls $0.05 
*** FLOP *** [3d 9d Qs]
Small Blind: checks
Hero: bets $0.15 
Small Blind: folds
Uncalled bet ($0.15) returned to Hero
Hero: doesn't show hand
Hero collected $0.19 from pot
*** SUMMARY ***
Total pot $0.2 | Rake $0.01
Board [3d 9d Qs]
Seat 1: Dealer (button) showed
Seat 2: Small Blind (small blind) showed
Seat 3: Hero (big blind) won ($0.19)
Seat 4: UTG showed
Seat 5: UTGplus1 showed
Seat 6: UTGplus2 showed



PokerStars Zoom Hand #3434788445: Hold'em No Limit ($0.02/$0.05) - 2017/03/10 0:12:06
Table '#952' 6-max Seat #5 is the button
Seat 1: Big Blind ($6.42 in chips)
Seat 2: UTG ($4.93 in chips)
Seat 3: UTGplus1 ($3.09 in chips)
Seat 4: Hero ($11.24 in chips)
Seat 5: Dealer ($5.35 in chips)
Seat 6: Small Blind ($4.30 in chips)
Small Blind: posts small blind $0.02
Big Blind: posts big blind $0.05
*** HOLE CARDS ***
Dealt to Hero [Tc 6h]
UTG: folds
UTGplus1: raises $0.15 to $0.15
Hero: folds
Dealer: folds
Small Blind: folds
Big Blind: calls $0.10 
*** FLOP *** [9s 2s 8h]
Big Blind: checks
UTGplus1: bets $0.20 
Big Blind: calls $0.20 
*** TURN *** [9s 2s 8h] [Ah]
Big Blind: checks
UTGplus1: checks
*** RIVER *** [9s 2s 8h Ah] [Kc]
Big Blind: bets $0.72 
UTGplus1: folds
Uncalled bet ($0.72) returned to Big Blind
Big Blind: doesn't show hand
Big Blind collected $0.69 from pot
*** SUMMARY ***
Total pot $0.72 | Rake $0.03
Board [9s 2s 8h Ah Kc]
Seat 1: Big Blind (big blind) won ($0.69)
Seat 2: UTG showed
Seat 3: UTGplus1 showed
Seat 4: Hero showed
Seat 5: Dealer (button) showed
Seat 6: Small Blind (small blind) showed



PokerStars Zoom Hand #3434788474: Hold'em No Limit ($0.02/$0.05) - 2017/03/10 0:12:11
Table '#952' 6-max Seat #1 is the button
Seat 1: Dealer ($4.81 in chips)
Seat 2: Hero ($11.24 in chips)
Seat 3: Big Blind ($4.93 in chips)
Seat 4: UTG ($12.19 in chips)
Seat 5: UTGplus1 ($5.01 in chips)
Seat 6: UTGplus2 ($1.21 in chips)
Hero: posts small blind $0.02
Big Blind: posts big blind $0.05
*** HOLE CARDS ***
Dealt to Hero [Td Ah]
UTG: folds
UTGplus1: raises $0.15 to $0.15
UTGplus2: folds
Dealer: folds
Hero: calls $0.13 
Big Blind: raises $0.45 to $0.50
UTGplus1: folds
Hero: calls $0.35 
*** FLOP *** [7s 5c 4s]
Hero: checks
Big Blind: bets $0.67 
Hero: calls $0.67 
*** TURN *** [7s 5c 4s] [4h]
Hero: checks
Big Blind: bets $3.76 and is all-in
Hero: folds
Uncalled bet ($3.76) returned to Big Blind
Big Blind: doesn't show hand
Big Blind collected $2.37 from pot
Table leave user
*** SUMMARY ***
Total pot $2.49 | Rake $0.12
Board [7s 5c 4s 4h]
Seat 1: Dealer (button) showed
Seat 2: Hero (small blind) showed
Seat 3: Big Blind (big blind) won ($2.37)
Seat 4: UTG showed
Seat 5: UTGplus1 showed
Seat 6: UTGplus2 showed



PokerStars Zoom Hand #3434788873: Hold'em No Limit ($0.02/$0.05) - 2017/03/10 0:13:05
Table '#952' 6-max Seat #1 is the button
Seat 1: Dealer ($21.68 in chips)
Seat 2: Small Blind ($4.89 in chips)
Seat 3: Big Blind ($6.15 in chips)
Seat 4: UTG ($5.20 in chips)
Seat 5: Hero ($10.07 in chips)
Seat 6: UTGplus2 ($4.89 in chips)
Small Blind: posts small blind $0.02
Big Blind: posts big blind $0.05
*** HOLE CARDS ***
Dealt to Hero [3d 6c]
UTG: folds
Hero: folds
UTGplus2: folds
Dealer: raises $0.12 to $0.12
Small Blind: folds
Big Blind: calls $0.07 
*** FLOP *** [4h Qh 2c]
Big Blind: bets $0.13 
Dealer: calls $0.13 
*** TURN *** [4h Qh 2c] [2s]
Big Blind: bets $0.26 
Dealer: calls $0.26 
*** RIVER *** [4h Qh 2c 2s] [Qc]
Big Blind: bets $0.52 
Dealer: calls $0.52 
*** SHOW DOWN ***
Big Blind: shows [As Qd] (a full house, Queens full of Deuces)
Dealer: shows [7d 7s] (Two pair)
Big Blind collected $1.98 from pot
*** SUMMARY ***
Total pot $2.08 | Rake $0.10
Board [4h Qh 2c 2s Qc]
Seat 1: Dealer (button) showed [7d 7s]
Seat 2: Small Blind (small blind) showed
Seat 3: Big Blind (big blind) showed [As Qd] and won ($1.98) with a full house, Queens full of Deuces
Seat 4: UTG showed
Seat 5: Hero showed
Seat 6: UTGplus2 showed



PokerStars Zoom Hand #3434788933: Hold'em No Limit ($0.02/$0.05) - 2017/03/10 0:13:12
Table '#952' 6-max Seat #4 is the button
Seat 1: UTG ($5 in chips)
Seat 2: Hero ($10.07 in chips)
Seat 3: UTGplus2 ($2.01 in chips)
Seat 4: Dealer ($4.57 in chips)
Seat 5: Small Blind ($10.10 in chips)
Seat 6: Big Blind ($6.18 in chips)
Small Blind: posts small blind $0.02
Big Blind: posts big blind $0.05
*** HOLE CARDS ***
Dealt to Hero [9s 6d]
UTG: folds
Hero: folds
UTGplus2: folds
Dealer: folds
Small Blind: raises $0.13 to $0.15
Big Blind: raises $0.35 to $0.40
Small Blind: calls $0.25 
*** FLOP *** [8d 9c 3d]
Small Blind: checks
Big Blind: bets $0.55 
Small Blind: folds
Uncalled bet ($0.55) returned to Big Blind
Big Blind: doesn't show hand
Big Blind collected $0.76 from pot
Seat re-join
*** SUMMARY ***
Total pot $0.8 | Rake $0.04
Board [8d 9c 3d]
Seat 1: UTG showed
Seat 2: Hero showed
Seat 3: UTGplus2 showed
Seat 4: Dealer (button) showed
Seat 5: Small Blind (small blind) showed
Seat 6: Big Blind (big blind) won ($0.76)



PokerStars Zoom Hand #3434788973: Hold'em No Limit ($0.02/$0.05) - 2017/03/10 0:13:17
Table '#952' 6-max Seat #4 is the button
Seat 1: UTG ($2.46 in chips)
Seat 2: UTGplus1 ($2.85 in chips)
Seat 3: UTGplus2 ($4.88 in chips)
Seat 4: Hero ($10.07 in chips)
Seat 5: Small Blind ($12.69 in chips)
Seat 6: Big Blind ($2.18 in chips)
Small Blind: posts small blind $0.02
Big Blind: posts big blind $0.05
*** HOLE CARDS ***
Dealt to Hero [Kh 9c]
UTG: folds
UTGplus1: raises $0.10 to $0.10
UTGplus2: folds
Hero: folds
Small Blind: folds
Big Blind: folds
Uncalled bet ($0.05) returned to UTGplus1
UTGplus1: doesn't show hand
UTGplus1 collected $0.12 from pot
*** SUMMARY ***
Total pot $0.12 | Rake $0.00
Seat 1: UTG showed
Seat 2: UTGplus1 won ($0.12)
Seat 3: UTGplus2 showed
Seat 4: Hero (button) showed
Seat 5: Small Blind (small blind) showed
Seat 6: Big Blind (big blind) showed



PokerStars Zoom Hand #3434789022: Hold'em No Limit ($0.02/$0.05) - 2017/03/10 0:13:23
Table '#952' 6-max Seat #5 is the button
Seat 1: Hero ($10.07 in chips)
Seat 2: UTG ($5.03 in chips)
Seat 3: UTGplus1 ($2.46 in chips)
Seat 4: UTGplus2 ($5.46 in chips)
Seat 5: Dealer ($2.13 in chips)
Seat 6: Small Blind ($8.12 in chips)
Small Blind: posts small blind $0.02
Hero: posts big blind $0.05
*** HOLE CARDS ***
Dealt to Hero [Jc Js]
UTG: folds
UTGplus1: folds
UTGplus2: folds
Dealer: folds
Small Blind: folds
Hero: doesn't show hand
Hero collected $0.07 from pot
*** SUMMARY ***
Total pot $0.07 | Rake $0.00
Seat 1: Hero (big blind) won ($0.07)
Seat 2: UTG showed
Seat 3: UTGplus1 showed
Seat 4: UTGplus2 showed
Seat 5: Dealer (button) showed
Seat 6: Small Blind (small blind) showed



PokerStars Zoom Hand #3434789147: Hold'em No Limit ($0.02/$0.05) - 2017/03/10 0:13:40
Table '#952' 6-max Seat #4 is the button
Seat 1: Hero ($10.09 in chips)
Seat 2: UTGplus1 ($5.57 in chips)
Seat 3: UTGplus2 ($8.78 in chips)
Seat 4: Dealer ($2.11 in chips)
Seat 5: Small Blind ($12.01 in chips)
Seat 6: Big Blind ($4.54 in chips)
Small Blind: posts small blind $0.02
Big Blind: posts big blind $0.05
*** HOLE CARDS ***
Dealt to Hero [4c Ts]
Hero: folds
UTGplus1: folds
UTGplus2: raises $0.15 to $0.15
Dealer: calls $0.15 
Small Blind: calls $0.13 
Big Blind: calls $0.10 
*** FLOP *** [6c Tc Kc]
Small Blind: checks
Big Blind: checks
UTGplus2: checks
Dealer: checks
*** TURN *** [6c Tc Kc] [3s]
Small Blind: checks
Big Blind: checks
UTGplus2: checks
Dealer: checks
*** RIVER *** [6c Tc Kc 3s] [2s]
Small Blind: bets $0.20 
Big Blind: folds
UTGplus2: calls $0.20 
Dealer: folds
*** SHOW DOWN ***
Small Blind: shows [Jd 9c] (high card King)
UTGplus2: shows [7d 7h] (a pair of Sevens)
UTGplus2 collected $0.95 from pot
*** SUMMARY ***
Total pot $1 | Rake $0.05
Board [6c Tc Kc 3s 2s]
Seat 1: Hero showed
Seat 2: UTGplus1 showed
Seat 3: UTGplus2 showed [7d 7h] and won ($0.95) with a pair of Sevens
Seat 4: Dealer (button) showed
Seat 5: Small Blind (small blind) showed [Jd 9c-Kc Jd Tc 9c 6c] and lost with high card Jack
Seat 6: Big Blind (big blind) showed



PokerStars Zoom Hand #3434789186: Hold'em No Limit ($0.02/$0.05) - 2017/03/10 0:13:45
Table '#952' 6-max Seat #6 is the button
Seat 1: Small Blind ($4.81 in chips)
Seat 2: Big Blind ($10.24 in chips)
Seat 3: UTG ($8.49 in chips)
Seat 4: UTGplus1 ($4.35 in chips)
Seat 5: UTGplus2 ($5.57 in chips)
Seat 6: Hero ($10.09 in chips)
Small Blind: posts small blind $0.02
Big Blind: posts big blind $0.05
*** HOLE CARDS ***
Dealt to Hero [Qd Kh]
UTG: folds
UTGplus1: folds
UTGplus2: raises $0.15 to $0.15
Hero: calls $0.15 
Small Blind: folds
Big Blind: folds
*** FLOP *** [3s 7h Kc]
UTGplus2: bets $0.23 
Hero: calls $0.23 
*** TURN *** [3s 7h Kc] [Qs]
UTGplus2: bets $0.51 
Hero: raises $1.51 to $1.51
UTGplus2: raises $3.68 to $5.19 and is all-in
Hero: calls $3.68 
*** RIVER *** [3s 7h Kc Qs] [Ac]
*** SHOW DOWN ***
UTGplus2: shows [7c 7s] (three of a kind, Sevens)
Hero: shows [Qd Kh] (two pair, Kings and Aces)
UTGplus2 collected $10.65 from pot
*** SUMMARY ***
Total pot $11.21 | Rake $0.56
Board [3s 7h Kc Qs Ac]
Seat 1: Small Blind (small blind) showed
Seat 2: Big Blind (big blind) showed
Seat 3: UTG showed
Seat 4: UTGplus1 showed
Seat 5: UTGplus2 showed [7c 7s] and won ($10.65) with three of a kind, Kings
Seat 6: Hero (button) showed [Qd Kh] and lost with two pair, Kings and Aces



PokerStars Zoom Hand #3434789592: Hold'em No Limit ($0.02/$0.05) - 2017/03/10 0:14:40
Table '#952' 6-max Seat #3 is the button
Seat 1: UTGplus1 ($5 in chips)
Seat 2: UTGplus2 ($10.65 in chips)
Seat 3: Hero ($4.52 in chips)
Seat 4: Small Blind ($14.85 in chips)
Seat 5: Big Blind ($5 in chips)
Seat 6: UTG ($2.78 in chips)
Small Blind: posts small blind $0.02
Big Blind: posts big blind $0.05
*** HOLE CARDS ***
Dealt to Hero [2d Kd]
UTG: folds
UTGplus1: folds
UTGplus2: folds
Hero: folds
Small Blind: calls $0.03 
Big Blind: raises $0.10 to $0.15
Small Blind: calls $0.10 
*** FLOP *** [Qs Kh 8h]
Small Blind: checks
Big Blind: checks
*** TURN *** [Qs Kh 8h] [7s]
Small Blind: checks
Big Blind: checks
*** RIVER *** [Qs Kh 8h 7s] [7d]
Small Blind: checks
Big Blind: checks
*** SHOW DOWN ***
Small Blind: shows [2c Jh] (a pair of Sevens)
Big Blind: shows [9h 8d] (two pair, Eights and Kings)
Big Blind collected $0.29 from pot
Table leave user
*** SUMMARY ***
Total pot $0.3 | Rake $0.01
Board [Qs Kh 8h 7s 7d]
Seat 1: UTGplus1 showed
Seat 2: UTGplus2 showed
Seat 3: Hero (button) showed
Seat 4: Small Blind (small blind) showed [2c Jh] and lost with a pair of Sevens
Seat 5: Big Blind (big blind) showed [9h 8d] and won ($0.29) with two pair, Eights and Kings
Seat 6: UTG showed



PokerStars Zoom Hand #3434789715: Hold'em No Limit ($0.02/$0.05) - 2017/03/10 0:14:57
Table '#952' 6-max Seat #6 is the button
Seat 1: Small Blind ($7.98 in chips)
Seat 2: Big Blind ($19.73 in chips)
Seat 3: Hero ($4.52 in chips)
Seat 4: UTGplus1 ($8.15 in chips)
Seat 5: UTGplus2 ($2.30 in chips)
Seat 6: Dealer ($5 in chips)
Small Blind: posts small blind $0.02
Big Blind: posts big blind $0.05
*** HOLE CARDS ***
Dealt to Hero [Kd Jc]
Hero: raises $0.17 to $0.17
UTGplus1: folds
UTGplus2: calls $0.17 
Dealer: folds
Small Blind: folds
Big Blind: folds
*** FLOP *** [3d Ac 3h]
Hero: bets $0.25 
UTGplus2: calls $0.25 
*** TURN *** [3d Ac 3h] [6s]
Hero: checks
UTGplus2: checks
*** RIVER *** [3d Ac 3h 6s] [4s]
Hero: checks
UTGplus2: checks
*** SHOW DOWN ***
Hero: shows [Kd Jc] (a pair of Threes)
UTGplus2: shows [5d Ad] (two pair, Aces and Sixs)
UTGplus2 collected $0.87 from pot
*** SUMMARY ***
Total pot $0.91 | Rake $0.04
Board [3d Ac 3h 6s 4s]
Seat 1: Small Blind (small blind) showed
Seat 2: Big Blind (big blind) showed
Seat 3: Hero showed [Kd Jc] and lost with a pair of Threes
Seat 4: UTGplus1 showed
Seat 5: UTGplus2 showed [5d Ad] and won ($0.87) with two pair, Aces and Sixes
Seat 6: Dealer (button) showed



PokerStars Zoom Hand #3434790246: Hold'em No Limit ($0.02/$0.05) - 2017/03/10 0:16:10
Table '#952' 6-max Seat #2 is the button
Seat 1: UTGplus2 ($3.73 in chips)
Seat 2: Dealer ($7.49 in chips)
Seat 3: Hero ($4.10 in chips)
Seat 4: Big Blind ($2.75 in chips)
Seat 5: UTG ($1.81 in chips)
Seat 6: UTGplus1 ($6.10 in chips)
Hero: posts small blind $0.02
Big Blind: posts big blind $0.05
*** HOLE CARDS ***
Dealt to Hero [5c 3d]
UTG: calls $0.05 
UTGplus1: folds
UTGplus2: folds
Dealer: raises $0.20 to $0.20
Hero: folds
Big Blind: calls $0.15 
UTG: calls $0.15 
*** FLOP *** [7d Ac Qc]
Big Blind: checks
UTG: bets $0.62 
Dealer: calls $0.62 
Big Blind: folds
*** TURN *** [7d Ac Qc] [7s]
UTG: bets $0.99 and is all-in
Dealer: calls $0.99 
*** RIVER *** [7d Ac Qc 7s] [4s]
*** SHOW DOWN ***
Dealer: shows [3h Ah] (two pair, Aces and Queens)
UTG: shows [2d Qd] (two pair, Queens and Aces)
Dealer collected $3.65 from pot
*** SUMMARY ***
Total pot $3.84 | Rake $0.19
Board [7d Ac Qc 7s 4s]
Seat 1: UTGplus2 showed
Seat 2: Dealer (button) showed [3h Ah] and won ($3.65) with two pair, Queens and Aces
Seat 3: Hero (small blind) showed
Seat 4: Big Blind (big blind) showed
Seat 5: UTG showed [2d Qd] and lost with two pair, Queens and Aces
Seat 6: UTGplus1 showed



PokerStars Zoom Hand #3434790289: Hold'em No Limit ($0.02/$0.05) - 2017/03/10 0:16:15
Table '#952' 6-max Seat #6 is the button
Seat 1: Small Blind ($10.10 in chips)
Seat 2: Big Blind ($3.73 in chips)
Seat 3: UTG ($25.09 in chips)
Seat 4: UTGplus1 ($14.65 in chips)
Seat 5: UTGplus2 ($3.34 in chips)
Seat 6: Hero ($4.08 in chips)
Small Blind: posts small blind $0.02
Big Blind: posts big blind $0.05
*** HOLE CARDS ***
Dealt to Hero [Qc 5d]
UTG: folds
UTGplus1: folds
UTGplus2: folds
Hero: folds
Small Blind: raises $0.13 to $0.15
Big Blind: folds
Uncalled bet ($0.10) returned to Small Blind
Small Blind: doesn't show hand
Small Blind collected $0.1 from pot
*** SUMMARY ***
Total pot $0.1 | Rake $0.00
Seat 1: Small Blind (small blind) won ($0.1)
Seat 2: Big Blind (big blind) showed
Seat 3: UTG showed
Seat 4: UTGplus1 showed
Seat 5: UTGplus2 showed
Seat 6: Hero (button) showed



PokerStars Zoom Hand #3434790331: Hold'em No Limit ($0.02/$0.05) - 2017/03/10 0:16:20
Table '#952' 6-max Seat #2 is the button
Seat 1: Hero ($4.08 in chips)
Seat 2: Dealer ($9.93 in chips)
Seat 3: Small Blind ($14.65 in chips)
Seat 4: Big Blind ($5 in chips)
Seat 5: UTG ($5.14 in chips)
Seat 6: UTGplus1 ($5 in chips)
Small Blind: posts small blind $0.02
Big Blind: posts big blind $0.05
*** HOLE CARDS ***
Dealt to Hero [2h Qd]
UTG: folds
UTGplus1: folds
Hero: folds
Dealer: folds
Small Blind: raises $0.08 to $0.10
Big Blind: folds
Uncalled bet ($0.05) returned to Small Blind
Small Blind: doesn't show hand
Small Blind collected $0.1 from pot
*** SUMMARY ***
Total pot $0.1 | Rake $0.00
Seat 1: Hero showed
Seat 2: Dealer (button) showed
Seat 3: Small Blind (small blind) won ($0.1)
Seat 4: Big Blind (big blind) showed
Seat 5: UTG showed
Seat 6: UTGplus1 showed



PokerStars Zoom Hand #3434790365: Hold'em No Limit ($0.02/$0.05) - 2017/03/10 0:16:25
Table '#952' 6-max Seat #1 is the button
Seat 1: Dealer ($5.14 in chips)
Seat 2: Small Blind ($5.60 in chips)
Seat 3: Hero ($4.08 in chips)
Seat 4: UTG ($5.82 in chips)
Seat 5: UTGplus1 ($4.58 in chips)
Seat 6: UTGplus2 ($5 in chips)
Small Blind: posts small blind $0.02
Hero: posts big blind $0.05
*** HOLE CARDS ***
Dealt to Hero [9d 4d]
UTG: folds
UTGplus1: calls $0.05 
UTGplus2: folds
Dealer: folds
Small Blind: calls $0.03 
Hero: checks
*** FLOP *** [Td 9c 2s]
Small Blind: checks
Hero: checks
UTGplus1: checks
*** TURN *** [Td 9c 2s] [Ks]
Small Blind: checks
Hero: checks
UTGplus1: bets $0.15 
Small Blind: calls $0.15 
Hero: folds
*** RIVER *** [Td 9c 2s Ks] [6c]
Small Blind: checks
UTGplus1: bets $0.45 
Small Blind: folds
*** SHOW DOWN ***
UTGplus1: shows [5h 4h] (high card King)
Uncalled bet ($0.45) returned to UTGplus1
UTGplus1 collected $0.43 from pot
*** SUMMARY ***
Total pot $0.45 | Rake $0.02
Board [Td 9c 2s Ks 6c]
Seat 1: Dealer (button) showed
Seat 2: Small Blind (small blind) showed
Seat 3: Hero (big blind) showed
Seat 4: UTG showed
Seat 5: UTGplus1 showed [5h 4h] and won ($0.43) with high card King
Seat 6: UTGplus2 showed



PokerStars Zoom Hand #3434790405: Hold'em No Limit ($0.02/$0.05) - 2017/03/10 0:16:30
Table '#952' 6-max Seat #6 is the button
Seat 1: Small Blind ($10.99 in chips)
Seat 2: Big Blind ($5 in chips)
Seat 3: UTG ($5 in chips)
Seat 4: Hero ($4.03 in chips)
Seat 5: UTGplus2 ($2.35 in chips)
Seat 6: Dealer ($5.93 in chips)
Small Blind: posts small blind $0.02
Big Blind: posts big blind $0.05
*** HOLE CARDS ***
Dealt to Hero [Kh 4d]
UTG: folds
Hero: folds
UTGplus2: folds
Dealer: raises $0.10 to $0.10
Small Blind: folds
Big Blind: folds
Uncalled bet ($0.05) returned to Dealer
Dealer: doesn't show hand
Dealer collected $0.12 from pot
*** SUMMARY ***
Total pot $0.12 | Rake $0.00
Seat 1: Small Blind (small blind) showed
Seat 2: Big Blind (big blind) showed
Seat 3: UTG showed
Seat 4: Hero showed
Seat 5: UTGplus2 showed
Seat 6: Dealer (button) won ($0.12)



PokerStars Zoom Hand #3434790436: Hold'em No Limit ($0.02/$0.05) - 2017/03/10 0:16:34
Table '#952' 6-max Seat #2 is the button
Seat 1: UTGplus2 ($6.35 in chips)
Seat 2: Dealer ($25.04 in chips)
Seat 3: Small Blind ($7.01 in chips)
Seat 4: Big Blind ($5 in chips)
Seat 5: UTG ($1.69 in chips)
Seat 6: Hero ($4.03 in chips)
Small Blind: posts small blind $0.02
Big Blind: posts big blind $0.05
*** HOLE CARDS ***
Dealt to Hero [Qc Tc]
UTG: folds
Hero: raises $0.17 to $0.17
UTGplus2: raises $0.44 to $0.44
Dealer: folds
Small Blind: calls $0.42 
Big Blind: folds
Hero: calls $0.27 
*** FLOP *** [8d 2c 6h]
Small Blind: checks
Hero: checks
UTGplus2: checks
*** TURN *** [8d 2c 6h] [Ks]
Small Blind: checks
Hero: checks
UTGplus2: bets $0.78 
Small Blind: calls $0.78 
Hero: folds
*** RIVER *** [8d 2c 6h Ks] [Th]
Small Blind: bets $1.01 
UTGplus2: folds
Uncalled bet ($1.01) returned to Small Blind
Small Blind: doesn't show hand
Small Blind collected $2.79 from pot
*** SUMMARY ***
Total pot $2.93 | Rake $0.14
Board [8d 2c 6h Ks Th]
Seat 1: UTGplus2 showed
Seat 2: Dealer (button) showed
Seat 3: Small Blind (small blind) won ($2.79)
Seat 4: Big Blind (big blind) showed
Seat 5: UTG showed
Seat 6: Hero showed



PokerStars Zoom Hand #3434790884: Hold'em No Limit ($0.02/$0.05) - 2017/03/10 0:17:33
Table '#952' 6-max Seat #5 is the button
Seat 1: Big Blind ($5.07 in chips)
Seat 2: UTG ($5 in chips)
Seat 3: UTGplus1 ($4.95 in chips)
Seat 4: Hero ($3.59 in chips)
Seat 5: Dealer ($2.28 in chips)
Seat 6: Small Blind ($3.83 in chips)
Small Blind: posts small blind $0.02
Big Blind: posts big blind $0.05
*** HOLE CARDS ***
Dealt to Hero [Ts 3d]
UTG: folds
UTGplus1: raises $0.15 to $0.15
Hero: folds
Dealer: folds
Small Blind: folds
Big Blind: folds
Uncalled bet ($0.10) returned to UTGplus1
UTGplus1: doesn't show hand
UTGplus1 collected $0.12 from pot
*** SUMMARY ***
Total pot $0.12 | Rake $0.00
Seat 1: Big Blind (big blind) showed
Seat 2: UTG showed
Seat 3: UTGplus1 won ($0.12)
Seat 4: Hero showed
Seat 5: Dealer (button) showed
Seat 6: Small Blind (small blind) showed



PokerStars Zoom Hand #3434790933: Hold'em No Limit ($0.02/$0.05) - 2017/03/10 0:17:38
Table '#952' 6-max Seat #6 is the button
Seat 1: Small Blind ($6.86 in chips)
Seat 2: Big Blind ($3.82 in chips)
Seat 3: UTG ($9.86 in chips)
Seat 4: UTGplus1 ($21.90 in chips)
Seat 5: Hero ($3.59 in chips)
Seat 6: Dealer ($5 in chips)
Small Blind: posts small blind $0.02
Big Blind: posts big blind $0.05
*** HOLE CARDS ***
Dealt to Hero [9h 6d]
UTG: folds
UTGplus1: folds
Hero: folds
Dealer: calls $0.05 
Small Blind: folds
Big Blind: checks
*** FLOP *** [6h 4s 2c]
Big Blind: bets $0.06 
Dealer: calls $0.06 
*** TURN *** [6h 4s 2c] [2h]
Big Blind: bets $0.12 
Dealer: calls $0.12 
*** RIVER *** [6h 4s 2c 2h] [Kd]
Big Blind: bets $0.24 
Dealer: calls $0.24 
*** SHOW DOWN ***
Big Blind: shows [7d 6c] (two pair, Sixs and Kings)
Dealer: shows [5c 4d] (Two pair)
Big Blind collected $0.92 from pot
*** SUMMARY ***
Total pot $0.96 | Rake $0.04
Board [6h 4s 2c 2h Kd]
Seat 1: Small Blind (small blind) showed
Seat 2: Big Blind (big blind) showed [7d 6c] and won ($0.92) with two pair, Sixes and Kings
Seat 3: UTG showed
Seat 4: UTGplus1 showed
Seat 5: Hero showed
Seat 6: Dealer (button) showed [5c 4d]



PokerStars Zoom Hand #3434790976: Hold'em No Limit ($0.02/$0.05) - 2017/03/10 0:17:44
Table '#952' 6-max Seat #5 is the button
Seat 1: Big Blind ($5.04 in chips)
Seat 2: UTG ($4.38 in chips)
Seat 3: Hero ($3.59 in chips)
Seat 4: UTGplus2 ($6.37 in chips)
Seat 5: Dealer ($9.86 in chips)
Seat 6: Small Blind ($3.12 in chips)
Small Blind: posts small blind $0.02
Big Blind: posts big blind $0.05
*** HOLE CARDS ***
Dealt to Hero [Ks As]
UTG: folds
Hero: raises $0.17 to $0.17
UTGplus2: folds
Dealer: folds
Small Blind: folds
Big Blind: folds
Uncalled bet ($0.12) returned to Hero
Hero: doesn't show hand
Hero collected $0.12 from pot
*** SUMMARY ***
Total pot $0.12 | Rake $0.00
Seat 1: Big Blind (big blind) showed
Seat 2: UTG showed
Seat 3: Hero won ($0.12)
Seat 4: UTGplus2 showed
Seat 5: Dealer (button) showed
Seat 6: Small Blind (small blind) showed



PokerStars Zoom Hand #3434791126: Hold'em No Limit ($0.02/$0.05) - 2017/03/10 0:18:04
Table '#952' 6-max Seat #3 is the button
Seat 1: UTGplus1 ($4.99 in chips)
Seat 2: UTGplus2 ($6.04 in chips)
Seat 3: Hero ($3.66 in chips)
Seat 4: Small Blind ($4.87 in chips)
Seat 5: Big Blind ($26.62 in chips)
Seat 6: UTG ($5.19 in chips)
Small Blind: posts small blind $0.02
Big Blind: posts big blind $0.05
*** HOLE CARDS ***
Dealt to Hero [Qd 7s]
UTG: folds
UTGplus1: folds
UTGplus2: raises $0.20 to $0.20
Hero: folds
Small Blind: folds
Big Blind: folds
Uncalled bet ($0.15) returned to UTGplus2
UTGplus2: doesn't show hand
UTGplus2 collected $0.12 from pot
*** SUMMARY ***
Total pot $0.12 | Rake $0.00
Seat 1: UTGplus1 showed
Seat 2: UTGplus2 won ($0.12)
Seat 3: Hero (button) showed
Seat 4: Small Blind (small blind) showed
Seat 5: Big Blind (big blind) showed
Seat 6: UTG showed



PokerStars Zoom Hand #3434791174: Hold'em No Limit ($0.02/$0.05) - 2017/03/10 0:18:10
Table '#952' 6-max Seat #5 is the button
Seat 1: Hero ($3.66 in chips)
Seat 2: UTG ($4.85 in chips)
Seat 3: UTGplus1 ($5.42 in chips)
Seat 4: UTGplus2 ($7.46 in chips)
Seat 5: Dealer ($4.76 in chips)
Seat 6: Small Blind ($5.85 in chips)
Small Blind: posts small blind $0.02
Hero: posts big blind $0.05
*** HOLE CARDS ***
Dealt to Hero [4s Qc]
UTG: raises $0.10 to $0.10
UTGplus1: folds
UTGplus2: folds
Dealer: folds
Small Blind: folds
Hero: folds
Uncalled bet ($0.05) returned to UTG
UTG: doesn't show hand
UTG collected $0.12 from pot
*** SUMMARY ***
Total pot $0.12 | Rake $0.00
Seat 1: Hero (big blind) showed
Seat 2: UTG won ($0.12)
Seat 3: UTGplus1 showed
Seat 4: UTGplus2 showed
Seat 5: Dealer (button) showed
Seat 6: Small Blind (small blind) showed



PokerStars Zoom Hand #3434791209: Hold'em No Limit ($0.02/$0.05) - 2017/03/10 0:18:14
Table '#952' 6-max Seat #1 is the button
Seat 1: Dealer ($2.33 in chips)
Seat 2: Small Blind ($7.46 in chips)
Seat 3: Big Blind ($14.66 in chips)
Seat 4: UTG ($10.86 in chips)
Seat 5: UTGplus1 ($4.76 in chips)
Seat 6: Hero ($3.61 in chips)
Small Blind: posts small blind $0.02
Big Blind: posts big blind $0.05
*** HOLE CARDS ***
Dealt to Hero [5s Qd]
UTG: folds
UTGplus1: raises $0.15 to $0.15
Hero: folds
Dealer: folds
Small Blind: folds
Big Blind: calls $0.10 
*** FLOP *** [Ks Jc 7s]
Big Blind: checks
UTGplus1: bets $0.21 
Big Blind: folds
Uncalled bet ($0.21) returned to UTGplus1
UTGplus1: doesn't show hand
UTGplus1 collected $0.31 from pot
*** SUMMARY ***
Total pot $0.32 | Rake $0.01
Board [Ks Jc 7s]
Seat 1: Dealer (button) showed
Seat 2: Small Blind (small blind) showed
Seat 3: Big Blind (big blind) showed
Seat 4: UTG showed
Seat 5: UTGplus1 won ($0.31)
Seat 6: Hero showed



PokerStars Zoom Hand #3434791246: Hold'em No Limit ($0.02/$0.05) - 2017/03/10 0:18:19
Table '#952' 6-max Seat #3 is the button
Seat 1: UTGplus1 ($6.84 in chips)
Seat 2: Hero ($3.61 in chips)
Seat 3: Dealer ($5.01 in chips)
Seat 4: Small Blind ($10.86 in chips)
Seat 5: Big Blind ($2.33 in chips)
Seat 6: UTG ($5.83 in chips)
Small Blind: posts small blind $0.02
Big Blind: posts big blind $0.05
*** HOLE CARDS ***
Dealt to Hero [5h 9h]
UTG: folds
UTGplus1: folds
Hero: raises $0.17 to $0.17
Dealer: folds
Small Blind: folds
Big Blind: folds
Uncalled bet ($0.12) returned to Hero
Hero: doesn't show hand
Hero collected $0.12 from pot
*** SUMMARY ***
Total pot $0.12 | Rake $0.00
Seat 1: UTGplus1 showed
Seat 2: Hero won ($0.12)
Seat 3: Dealer (button) showed
Seat 4: Small Blind (small blind) showed
Seat 5: Big Blind (big blind) showed
Seat 6: UTG showed



PokerStars Zoom Hand #3434791373: Hold'em No Limit ($0.02/$0.05) - 2017/03/10 0:18:37
Table '#952' 6-max Seat #5 is the button
Seat 1: Big Blind ($5 in chips)
Seat 2: UTG ($21.83 in chips)
Seat 3: UTGplus1 ($5.78 in chips)
Seat 4: UTGplus2 ($5.04 in chips)
Seat 5: Hero ($3.68 in chips)
Seat 6: Small Blind ($4 in chips)
Small Blind: posts small blind $0.02
Big Blind: posts big blind $0.05
*** HOLE CARDS ***
Dealt to Hero [5d 4c]
UTG: folds
UTGplus1: raises $0.15 to $0.15
UTGplus2: calls $0.15 
Hero: folds
Small Blind: folds
Big Blind: calls $0.10 
*** FLOP *** [8s Ad 4h]
Big Blind: checks
UTGplus1: bets $0.23 
UTGplus2: folds
Big Blind: calls $0.23 
*** TURN *** [8s Ad 4h] [Jh]
Big Blind: checks
UTGplus1: checks
*** RIVER *** [8s Ad 4h Jh] [Qc]
Big Blind: bets $0.93 
UTGplus1: calls $0.93 
*** SHOW DOWN ***
Big Blind: shows [As Jd] (two pair, Aces and Queens)
UTGplus1: shows [Ac 3c] (One pair)
Big Blind collected $2.66 from pot
*** SUMMARY ***
Total pot $2.79 | Rake $0.13
Board [8s Ad 4h Jh Qc]
Seat 1: Big Blind (big blind) showed [As Jd] and won ($2.66) with two pair, Aces and Queens
Seat 2: UTG showed
Seat 3: UTGplus1 showed [Ac 3c]
Seat 4: UTGplus2 showed
Seat 5: Hero (button) showed
Seat 6: Small Blind (small blind) showed



PokerStars Zoom Hand #3434791441: Hold'em No Limit ($0.02/$0.05) - 2017/03/10 0:18:46
Table '#952' 6-max Seat #5 is the button
Seat 1: Big Blind ($6.09 in chips)
Seat 2: Hero ($3.68 in chips)
Seat 3: UTGplus1 ($5.17 in chips)
Seat 4: UTGplus2 ($7.77 in chips)
Seat 5: Dealer ($10.05 in chips)
Seat 6: Small Blind ($4.04 in chips)
Small Blind: posts small blind $0.02
Big Blind: posts big blind $0.05
*** HOLE CARDS ***
Dealt to Hero [3h Kh]
Hero: folds
UTGplus1: folds
UTGplus2: folds
Dealer: folds
Small Blind: calls $0.03 
Big Blind: checks
*** FLOP *** [3c 6s Jh]
Small Blind: bets $0.10 
Big Blind: folds
Uncalled bet ($0.10) returned to Small Blind
Small Blind: doesn't show hand
Small Blind collected $0.1 from pot
*** SUMMARY ***
Total pot $0.1 | Rake $0.00
Board [3c 6s Jh]
Seat 1: Big Blind (big blind) showed
Seat 2: Hero showed
Seat 3: UTGplus1 showed
Seat 4: UTGplus2 showed
Seat 5: Dealer (button) showed
Seat 6: Small Blind (small blind) won ($0.1)



PokerStars Zoom Hand #3434791475: Hold'em No Limit ($0.02/$0.05) - 2017/03/10 0:18:50
Table '#952' 6-max Seat #5 is the button
Seat 1: Big Blind ($2.26 in chips)
Seat 2: UTG ($5.15 in chips)
Seat 3: UTGplus1 ($14.27 in chips)
Seat 4: Hero ($3.68 in chips)
Seat 5: Dealer ($7.77 in chips)
Seat 6: Small Blind ($26.55 in chips)
Small Blind: posts small blind $0.02
Big Blind: posts big blind $0.05
*** HOLE CARDS ***
Dealt to Hero [9s Qs]
UTG: raises $0.15 to $0.15
UTGplus1: folds
Hero: calls $0.15 
Dealer: folds
Small Blind: folds
Big Blind: folds
*** FLOP *** [4s 7c Jc]
UTG: checks
Hero: checks
*** TURN *** [4s 7c Jc] [5d]
UTG: bets $0.18 
Hero: folds
Uncalled bet ($0.18) returned to UTG
UTG: doesn't show hand
UTG collected $0.36 from pot
Seat re-join
*** SUMMARY ***
Total pot $0.37 | Rake $0.01
Board [4s 7c Jc 5d]
Seat 1: Big Blind (big blind) showed
Seat 2: UTG won ($0.36)
Seat 3: UTGplus1 showed
Seat 4: Hero showed
Seat 5: Dealer (button) showed
Seat 6: Small Blind (small blind) showed



PokerStars Zoom Hand #3434791771: Hold'em No Limit ($0.02/$0.05) - 2017/03/10 0:19:28
Table '#952' 6-max Seat #3 is the button
Seat 1: UTGplus1 ($1.87 in chips)
Seat 2: UTGplus2 ($6.35 in chips)
Seat 3: Dealer ($19.97 in chips)
Seat 4: Small Blind ($4.57 in chips)
Seat 5: Hero ($3.53 in chips)
Seat 6: UTG ($10.94 in chips)
Small Blind: posts small blind $0.02
Hero: posts big blind $0.05
*** HOLE CARDS ***
Dealt to Hero [7c 3c]
UTG: raises $0.20 to $0.20
UTGplus1: folds
UTGplus2: folds
Dealer: folds
Small Blind: folds
Hero: folds
Uncalled bet ($0.15) returned to UTG
UTG: doesn't show hand
UTG collected $0.12 from pot
*** SUMMARY ***
Total pot $0.12 | Rake $0.00
Seat 1: UTGplus1 showed
Seat 2: UTGplus2 showed
Seat 3: Dealer (button) showed
Seat 4: Small Blind (small blind) showed
Seat 5: Hero (big blind) showed
Seat 6: UTG won ($0.12)



PokerStars Zoom Hand #3434791821: Hold'em No Limit ($0.02/$0.05) - 2017/03/10 0:19:34
Table '#952' 6-max Seat #6 is the button
Seat 1: Hero ($3.48 in chips)
Seat 2: Big Blind ($5.10 in chips)
Seat 3: UTG ($9.69 in chips)
Seat 4: UTGplus1 ($4.08 in chips)
Seat 5: UTGplus2 ($2.11 in chips)
Seat 6: Dealer ($5.50 in chips)
Hero: posts small blind $0.02
Big Blind: posts big blind $0.05
*** HOLE CARDS ***
Dealt to Hero [9d Jh]
UTG: folds
UTGplus1: folds
UTGplus2: raises $0.15 to $0.15
Dealer: folds
Hero: calls $0.13 
Big Blind: folds
*** FLOP *** [6d Qh 8c]
Hero: checks
UTGplus2: checks
*** TURN *** [6d Qh 8c] [6s]
Hero: bets $0.27 
UTGplus2: folds
Uncalled bet ($0.27) returned to Hero
Hero: doesn't show hand
Hero collected $0.34 from pot
Table deposit $5 
*** SUMMARY ***
Total pot $0.35 | Rake $0.01
Board [6d Qh 8c 6s]
Seat 1: Hero (small blind) won ($0.34)
Seat 2: Big Blind (big blind) showed
Seat 3: UTG showed
Seat 4: UTGplus1 showed
Seat 5: UTGplus2 showed
Seat 6: Dealer (button) showed



PokerStars Zoom Hand #3434792198: Hold'em No Limit ($0.02/$0.05) - 2017/03/10 0:20:22
Table '#952' 6-max Seat #6 is the button
Seat 1: Small Blind ($1.81 in chips)
Seat 2: Big Blind ($6.73 in chips)
Seat 3: Hero ($5 in chips)
Seat 4: UTGplus1 ($7.92 in chips)
Seat 5: UTGplus2 ($7.76 in chips)
Seat 6: Dealer ($10 in chips)
Small Blind: posts small blind $0.02
Big Blind: posts big blind $0.05
*** HOLE CARDS ***
Dealt to Hero [Ks Th]
Hero: raises $0.17 to $0.17
UTGplus1: calls $0.17 
UTGplus2: folds
Dealer: folds
Small Blind: folds
Big Blind: folds
*** FLOP *** [Kc Qs 9c]
Hero: bets $0.30 
UTGplus1: calls $0.30 
*** TURN *** [Kc Qs 9c] [2c]
Hero: bets $0.65 
UTGplus1: calls $0.65 
*** RIVER *** [Kc Qs 9c 2c] [2s]
Hero: bets $1.25 
UTGplus1: raises $2.50 to $2.50
Hero: calls $1.25 
*** SHOW DOWN ***
UTGplus1: shows [Ac 3c] (a flush, Ace high)
Hero: shows [Ks Th] (Two pair)
UTGplus1 collected $6.95 from pot
Table leave user
Table leave user
Table deposit $5 
*** SUMMARY ***
Total pot $7.31 | Rake $0.36
Board [Kc Qs 9c 2c 2s]
Seat 1: Small Blind (small blind) showed
Seat 2: Big Blind (big blind) showed
Seat 3: Hero showed [Ks Th]
Seat 4: UTGplus1 showed [Ac 3c] and won ($6.95) with a flush, Ace high
Seat 5: UTGplus2 showed
Seat 6: Dealer (button) showed



PokerStars Zoom Hand #3434792896: Hold'em No Limit ($0.02/$0.05) - 2017/03/10 0:21:49
Table '#952' 6-max Seat #3 is the button
Seat 1: UTGplus1 ($5.60 in chips)
Seat 2: UTGplus2 ($14.16 in chips)
Seat 3: Hero ($1.38 in chips)
Seat 4: Small Blind ($11.25 in chips)
Seat 5: Big Blind ($5.53 in chips)
Seat 6: UTG ($5.15 in chips)
Small Blind: posts small blind $0.02
Big Blind: posts big blind $0.05
*** HOLE CARDS ***
Dealt to Hero [Jd 5d]
UTG: raises $0.13 to $0.13
UTGplus1: folds
UTGplus2: calls $0.13 
Hero: folds (auth)
Small Blind: folds
Hero: Table leave user
Big Blind: calls $0.08 
*** FLOP *** [Tc Td 3s]
Big Blind: checks
UTG: checks 
UTGplus2: checks
*** TURN *** [Tc Td 3s] [Ah]
Big Blind: checks
UTG: checks
UTGplus2: checks
*** RIVER *** [Tc Td 3s Ah] [5s]
Big Blind: checks
UTG: checks
UTGplus2: checks
*** SHOW DOWN ***
Big Blind: shows [Js 7s] (a pair of Tens)
UTG: shows [2h 2s] (two pair, Tens and Aces)
UTGplus2: shows [Qc Jh] (One pair)
UTG collected $0.39 from pot
*** SUMMARY ***
Total pot $0.41 | Rake $0.02
Board [Tc Td 3s Ah 5s]
Seat 1: UTGplus1 showed
Seat 2: UTGplus2 showed [Qc Jh]
Seat 3: Hero (button) showed
Seat 4: Small Blind (small blind) showed
Seat 5: Big Blind (big blind) showed [Js 7s] and lost with a pair of Tens
Seat 6: UTG showed [2h 2s] and won ($0.39) with two pair, Tens and Aces




