PokerStars Zoom Hand #3434324544: Hold'em No Limit ($0.02/$0.05) - 2017/03/08 22:33:08
Table '#952' 6-max Seat #2 is the button
Seat 1: UTGplus2 ($2.93 in chips)
Seat 2: Dealer ($19.80 in chips)
Seat 3: Small Blind ($16.09 in chips)
Seat 4: Hero ($5 in chips)
Seat 5: UTG ($1.89 in chips)
Seat 6: UTGplus1 ($6.16 in chips)
Small Blind: posts small blind $0.02
Hero: posts big blind $0.05
*** HOLE CARDS ***
Dealt to Hero [9s 6h]
UTG: folds
UTGplus1: raises $0.15 to $0.15
UTGplus2: folds
Dealer: folds
Small Blind: folds
Hero: folds
Uncalled bet ($0.10) returned to UTGplus1
UTGplus1: doesn't show hand
UTGplus1 collected $0.12 from pot
*** SUMMARY ***
Total pot $0.12 | Rake $0.00
Seat 1: UTGplus2 showed
Seat 2: Dealer (button) showed
Seat 3: Small Blind (small blind) showed
Seat 4: Hero (big blind) showed
Seat 5: UTG showed
Seat 6: UTGplus1 won ($0.12)



PokerStars Zoom Hand #3434324724: Hold'em No Limit ($0.02/$0.05) - 2017/03/08 22:33:28
Table '#952' 6-max Seat #6 is the button
Seat 1: Small Blind ($6.12 in chips)
Seat 2: Big Blind ($5.68 in chips)
Seat 3: UTG ($4.47 in chips)
Seat 4: UTGplus1 ($2.67 in chips)
Seat 5: UTGplus2 ($9.77 in chips)
Seat 6: Hero ($4.95 in chips)
Small Blind: posts small blind $0.02
Big Blind: posts big blind $0.05
*** HOLE CARDS ***
Dealt to Hero [6h 3c]
UTG: folds
UTGplus1: folds
UTGplus2: raises $0.15 to $0.15
Hero: folds
Small Blind: folds
Big Blind: folds
Uncalled bet ($0.10) returned to UTGplus2
UTGplus2: doesn't show hand
UTGplus2 collected $0.12 from pot
*** SUMMARY ***
Total pot $0.12 | Rake $0.00
Seat 1: Small Blind (small blind) showed
Seat 2: Big Blind (big blind) showed
Seat 3: UTG showed
Seat 4: UTGplus1 showed
Seat 5: UTGplus2 won ($0.12)
Seat 6: Hero (button) showed



PokerStars Zoom Hand #3434324796: Hold'em No Limit ($0.02/$0.05) - 2017/03/08 22:33:37
Table '#952' 6-max Seat #6 is the button
Seat 1: Small Blind ($11.61 in chips)
Seat 2: Big Blind ($2.67 in chips)
Seat 3: UTG ($3.37 in chips)
Seat 4: Hero ($4.95 in chips)
Seat 5: UTGplus2 ($8.24 in chips)
Seat 6: Dealer ($9.88 in chips)
Small Blind: posts small blind $0.02
Big Blind: posts big blind $0.05
*** HOLE CARDS ***
Dealt to Hero [8h Qc]
UTG: folds
Hero: folds
UTGplus2: folds 
Dealer: folds
Small Blind: folds
*** SHOW DOWN ***
Big Blind: shows [6d 4h] (high card Six)
Big Blind collected $0.07 from pot
*** SUMMARY ***
Total pot $0.07 | Rake $0.00
Seat 1: Small Blind (small blind) showed
Seat 2: Big Blind (big blind) collected $0.02
Seat 3: UTG showed
Seat 4: Hero showed
Seat 5: UTGplus2 showed
Seat 6: Dealer (button) showed



PokerStars Zoom Hand #3434324848: Hold'em No Limit ($0.02/$0.05) - 2017/03/08 22:33:43
Table '#952' 6-max Seat #5 is the button
Seat 1: Big Blind ($2.64 in chips)
Seat 2: UTG ($5.28 in chips)
Seat 3: UTGplus1 ($6.71 in chips)
Seat 4: UTGplus2 ($1.98 in chips)
Seat 5: Dealer ($2.51 in chips)
Seat 6: Hero ($4.95 in chips)
Hero: posts small blind $0.02
Big Blind: posts big blind $0.05
*** HOLE CARDS ***
Dealt to Hero [As Tc]
UTG: calls $0.05 
UTGplus1: folds
UTGplus2: raises $0.15 to $0.15
Dealer: folds
Hero: calls $0.13 
Big Blind: folds
UTG: calls $0.10 
*** FLOP *** [4s Ah 3d]
Hero: checks
UTG: bets $0.05 
UTGplus2: calls $0.05 
Hero: raises $0.35 to $0.35
UTG: calls $0.30 
UTGplus2: calls $0.30 
*** TURN *** [4s Ah 3d] [Ks]
Hero: bets $0.87 
UTG: raises $4.75 to $4.75
UTGplus2: folds
Hero: calls $3.58 and is all-in
*** RIVER *** [4s Ah 3d Ks] [Ac]
*** SHOW DOWN ***
UTG: shows [Kd 5d] (two pair, Aces and Fives)
Hero: shows [As Tc] (three of a kind, Aces)
Uncalled bet ($0.30) returned to UTG
Hero collected $9.93 from pot
UTG: Table leave user
*** SUMMARY ***
Total pot $10.45 | Rake $0.52
Board [4s Ah 3d Ks Ac]
Seat 1: Big Blind (big blind) showed
Seat 2: UTG showed [Kd 5d] and lost with two pair, Aces and Fives
Seat 3: UTGplus1 showed
Seat 4: UTGplus2 showed
Seat 5: Dealer (button) showed
Seat 6: Hero (small blind) showed [As Tc] and won ($9.93) with three of a kind, Aces



PokerStars Zoom Hand #3434325447: Hold'em No Limit ($0.02/$0.05) - 2017/03/08 22:34:54
Table '#952' 6-max Seat #4 is the button
Seat 1: UTG ($4.67 in chips)
Seat 2: UTGplus1 ($11.50 in chips)
Seat 3: UTGplus2 ($2.57 in chips)
Seat 4: Dealer ($9.50 in chips)
Seat 5: Small Blind ($4.01 in chips)
Seat 6: Hero ($9.93 in chips)
Small Blind: posts small blind $0.02
Hero: posts big blind $0.05
*** HOLE CARDS ***
Dealt to Hero [4d 5h]
UTG: folds
UTGplus1: folds
UTGplus2: folds
Dealer: folds
Small Blind: folds
*** SHOW DOWN ***
Hero: shows [4d 5h] (high card Four)
Hero collected $0.07 from pot
Dealer: Table leave user
*** SUMMARY ***
Total pot $0.07 | Rake $0.00
Seat 1: UTG showed
Seat 2: UTGplus1 showed
Seat 3: UTGplus2 showed
Seat 4: Dealer (button) showed [3c 9s]
Seat 5: Small Blind (small blind) showed
Seat 6: Hero (big blind) collected $0.02



PokerStars Zoom Hand #3434325606: Hold'em No Limit ($0.02/$0.05) - 2017/03/08 22:35:12
Table '#952' 6-max Seat #5 is the button
Seat 1: Big Blind ($3.25 in chips)
Seat 2: UTG ($3.21 in chips)
Seat 3: Hero ($9.88 in chips)
Seat 4: UTGplus2 ($6.72 in chips)
Seat 5: Dealer ($4.82 in chips)
Seat 6: Small Blind ($2.52 in chips)
Small Blind: posts small blind $0.02
Big Blind: posts big blind $0.05
*** HOLE CARDS ***
Dealt to Hero [6d 5h]
UTG: folds
Hero: raises $0.17 to $0.17
UTGplus2: folds
Dealer: folds
Small Blind: folds
Big Blind: folds
Uncalled bet ($0.12) returned to Hero
Hero: doesn't show hand
Hero collected $0.12 from pot
*** SUMMARY ***
Total pot $0.12 | Rake $0.00
Seat 1: Big Blind (big blind) showed
Seat 2: UTG showed
Seat 3: Hero won ($0.12)
Seat 4: UTGplus2 showed
Seat 5: Dealer (button) showed
Seat 6: Small Blind (small blind) showed



PokerStars Zoom Hand #3434325828: Hold'em No Limit ($0.02/$0.05) - 2017/03/08 22:35:40
Table '#952' 6-max Seat #1 is the button
Seat 1: Dealer ($9.61 in chips)
Seat 2: Small Blind ($0.72 in chips)
Seat 3: Big Blind ($5.83 in chips)
Seat 4: UTG ($8.02 in chips)
Seat 5: Hero ($10.02 in chips)
Seat 6: UTGplus2 ($3.59 in chips)
Small Blind: posts small blind $0.02
Big Blind: posts big blind $0.05
*** HOLE CARDS ***
Dealt to Hero [Th 4s]
UTG: folds
Hero: folds
UTGplus2: folds
Dealer: folds
Small Blind: folds
Big Blind: doesn't show hand
Big Blind collected $0.07 from pot
Table deposit $5 
*** SUMMARY ***
Total pot $0.07 | Rake $0.00
Seat 1: Dealer (button) showed
Seat 2: Small Blind (small blind) showed
Seat 3: Big Blind (big blind) won ($0.07)
Seat 4: UTG showed
Seat 5: Hero showed
Seat 6: UTGplus2 showed



PokerStars Zoom Hand #3434325895: Hold'em No Limit ($0.02/$0.05) - 2017/03/08 22:35:47
Table '#952' 6-max Seat #4 is the button
Seat 1: UTG ($2.44 in chips)
Seat 2: UTGplus1 ($2.54 in chips)
Seat 3: UTGplus2 ($4.98 in chips)
Seat 4: Hero ($10.02 in chips)
Seat 5: Small Blind ($15.11 in chips)
Seat 6: Big Blind ($9.77 in chips)
Small Blind: posts small blind $0.02
Big Blind: posts big blind $0.05
*** HOLE CARDS ***
Dealt to Hero [9c Td]
UTG: calls $0.05 
UTGplus1: calls $0.05 
UTGplus2: folds
Hero: raises $0.27 to $0.27
Small Blind: calls $0.25 
Big Blind: folds
UTG: calls $0.22 
UTGplus1: calls $0.22 
*** FLOP *** [8c 4d 3s]
Small Blind: checks
UTG: checks
UTGplus1: checks
Hero: bets $0.61 
Small Blind: folds
UTG: folds
UTGplus1: folds
Uncalled bet ($0.61) returned to Hero
Hero: doesn't show hand
Hero collected $1.08 from pot
*** SUMMARY ***
Total pot $1.13 | Rake $0.05
Board [8c 4d 3s]
Seat 1: UTG showed
Seat 2: UTGplus1 showed
Seat 3: UTGplus2 showed
Seat 4: Hero (button) won ($1.08)
Seat 5: Small Blind (small blind) showed
Seat 6: Big Blind (big blind) showed



PokerStars Zoom Hand #3434326419: Hold'em No Limit ($0.02/$0.05) - 2017/03/08 22:36:48
Table '#952' 6-max Seat #2 is the button
Seat 1: UTGplus2 ($3.54 in chips)
Seat 2: Hero ($10.83 in chips)
Seat 3: Small Blind ($14.84 in chips)
Seat 4: Big Blind ($1.58 in chips)
Seat 5: UTG ($3.49 in chips)
Seat 6: UTGplus1 ($4.91 in chips)
Small Blind: posts small blind $0.02
Big Blind: posts big blind $0.05
*** HOLE CARDS ***
Dealt to Hero [Qs Kc]
UTG: folds
UTGplus1: folds
UTGplus2: folds
Hero: raises $0.17 to $0.17
Small Blind: folds
Big Blind: folds
Uncalled bet ($0.12) returned to Hero
Hero: doesn't show hand
Hero collected $0.12 from pot
*** SUMMARY ***
Total pot $0.12 | Rake $0.00
Seat 1: UTGplus2 showed
Seat 2: Hero (button) won ($0.12)
Seat 3: Small Blind (small blind) showed
Seat 4: Big Blind (big blind) showed
Seat 5: UTG showed
Seat 6: UTGplus1 showed



PokerStars Zoom Hand #3434326683: Hold'em No Limit ($0.02/$0.05) - 2017/03/08 22:37:20
Table '#952' 6-max Seat #5 is the button
Seat 1: Big Blind ($4.96 in chips)
Seat 2: Hero ($10.90 in chips)
Seat 3: UTGplus1 ($9.52 in chips)
Seat 4: UTGplus2 ($11.92 in chips)
Seat 5: Dealer ($1.53 in chips)
Seat 6: Small Blind ($4.75 in chips)
Small Blind: posts small blind $0.02
Big Blind: posts big blind $0.05
*** HOLE CARDS ***
Dealt to Hero [Qs Qd]
Hero: raises $0.17 to $0.17
UTGplus1: folds
UTGplus2: folds
Dealer: calls $0.17 
Small Blind: folds
Big Blind: folds
*** FLOP *** [2h 4c Ts]
Hero: bets $0.25 
Dealer: calls $0.25 
*** TURN *** [2h 4c Ts] [9h]
Hero: bets $0.65 
Dealer: folds
Uncalled bet ($0.65) returned to Hero
Hero: doesn't show hand
Hero collected $0.87 from pot
Table deposit $5 
*** SUMMARY ***
Total pot $0.91 | Rake $0.04
Board [2h 4c Ts 9h]
Seat 1: Big Blind (big blind) showed
Seat 2: Hero won ($0.87)
Seat 3: UTGplus1 showed
Seat 4: UTGplus2 showed
Seat 5: Dealer (button) showed
Seat 6: Small Blind (small blind) showed



PokerStars Zoom Hand #3434327178: Hold'em No Limit ($0.02/$0.05) - 2017/03/08 22:38:21
Table '#952' 6-max Seat #5 is the button
Seat 1: Hero ($11.35 in chips)
Seat 2: UTG ($4.97 in chips)
Seat 3: UTGplus1 ($4.56 in chips)
Seat 4: UTGplus2 ($3.40 in chips)
Seat 5: Dealer ($3.32 in chips)
Seat 6: Small Blind ($20.58 in chips)
Small Blind: posts small blind $0.02
Hero: posts big blind $0.05
*** HOLE CARDS ***
Dealt to Hero [7h 4s]
UTG: folds
UTGplus1: calls $0.05 
UTGplus2: calls $0.05 
Dealer: folds
Small Blind: raises $0.18 to $0.20
Hero: folds
UTGplus1: calls $0.15 
UTGplus2: calls $0.15 
*** FLOP *** [Jh 9s 6h]
Small Blind: bets $0.35 
UTGplus1: folds
UTGplus2: calls $0.35 
*** TURN *** [Jh 9s 6h] [4h]
Small Blind: checks
UTGplus2: checks
*** RIVER *** [Jh 9s 6h 4h] [2d]
Small Blind: checks
UTGplus2: checks
*** SHOW DOWN ***
Small Blind: shows [Kd Jd] (a pair of Jacks)
UTGplus2: shows [8d 9d] (One pair)
Small Blind collected $1.29 from pot
*** SUMMARY ***
Total pot $1.35 | Rake $0.06
Board [Jh 9s 6h 4h 2d]
Seat 1: Hero (big blind) showed
Seat 2: UTG showed
Seat 3: UTGplus1 showed
Seat 4: UTGplus2 showed [8d 9d]
Seat 5: Dealer (button) showed
Seat 6: Small Blind (small blind) showed [Kd Jd] and won ($1.29) with a pair of Jacks



PokerStars Zoom Hand #3434327273: Hold'em No Limit ($0.02/$0.05) - 2017/03/08 22:38:31
Table '#952' 6-max Seat #5 is the button
Seat 1: Big Blind ($6.53 in chips)
Seat 2: UTG ($7.13 in chips)
Seat 3: UTGplus1 ($2.22 in chips)
Seat 4: UTGplus2 ($3.49 in chips)
Seat 5: Hero ($11.30 in chips)
Seat 6: Small Blind ($2.78 in chips)
Small Blind: posts small blind $0.02
Big Blind: posts big blind $0.05
*** HOLE CARDS ***
Dealt to Hero [5d 2h]
UTG: raises $0.15 to $0.15
UTGplus1: calls $0.15 
UTGplus2: calls $0.15 
Hero: folds
Small Blind: folds
Big Blind: folds
*** FLOP *** [7h 8d 9h]
UTG: bets $0.31 
UTGplus1: calls $0.31 
UTGplus2: calls $0.31 
*** TURN *** [7h 8d 9h] [7s]
UTG: checks
UTGplus1: bets $1 
UTGplus2: calls $1 
UTG: folds
*** RIVER *** [7h 8d 9h 7s] [Jh]
UTGplus1: checks
UTGplus2: bets $0.85 
UTGplus1: calls $0.76 and is all-in
*** SHOW DOWN ***
UTGplus2: shows [Td Ad] (a straight, Seven to Jack)
UTGplus1: shows [Js 8s] (Two pair)
Uncalled bet ($0.09) returned to UTGplus2
UTGplus2 collected $4.73 from pot
*** SUMMARY ***
Total pot $4.97 | Rake $0.24
Board [7h 8d 9h 7s Jh]
Seat 1: Big Blind (big blind) showed
Seat 2: UTG showed
Seat 3: UTGplus1 showed [Js 8s]
Seat 4: UTGplus2 showed [Td Ad] and won ($4.73) with a straight, Seven to Jack
Seat 5: Hero (button) showed
Seat 6: Small Blind (small blind) showed



PokerStars Zoom Hand #3434327317: Hold'em No Limit ($0.02/$0.05) - 2017/03/08 22:38:37
Table '#952' 6-max Seat #3 is the button
Seat 1: UTGplus1 ($5.12 in chips)
Seat 2: UTGplus2 ($3.47 in chips)
Seat 3: Dealer ($2.27 in chips)
Seat 4: Hero ($11.30 in chips)
Seat 5: Big Blind ($2.36 in chips)
Seat 6: UTG ($4.81 in chips)
Hero: posts small blind $0.02
Big Blind: posts big blind $0.05
*** HOLE CARDS ***
Dealt to Hero [Td 9s]
UTG: folds
UTGplus1: folds
UTGplus2: raises $0.17 to $0.17
Dealer: calls $0.17 
Hero: folds
Big Blind: calls $0.12 
*** FLOP *** [6s Qc Th]
Big Blind: checks
UTGplus2: bets $0.26 
Dealer: folds
Big Blind: calls $0.26 
*** TURN *** [6s Qc Th] [3s]
Big Blind: bets $0.35 
UTGplus2: folds
Uncalled bet ($0.35) returned to Big Blind
Big Blind: doesn't show hand
Big Blind collected $1 from pot
*** SUMMARY ***
Total pot $1.05 | Rake $0.05
Board [6s Qc Th 3s]
Seat 1: UTGplus1 showed
Seat 2: UTGplus2 showed
Seat 3: Dealer (button) showed
Seat 4: Hero (small blind) showed
Seat 5: Big Blind (big blind) won ($1)
Seat 6: UTG showed



PokerStars Zoom Hand #3434327567: Hold'em No Limit ($0.02/$0.05) - 2017/03/08 22:39:08
Table '#952' 6-max Seat #4 is the button
Seat 1: Hero ($11.28 in chips)
Seat 2: UTGplus1 ($4.72 in chips)
Seat 3: UTGplus2 ($8.55 in chips)
Seat 4: Dealer ($1.54 in chips)
Seat 5: Small Blind ($4.14 in chips)
Seat 6: Big Blind ($5.38 in chips)
Small Blind: posts small blind $0.02
Big Blind: posts big blind $0.05
*** HOLE CARDS ***
Dealt to Hero [6s 5h]
Hero: folds
UTGplus1: folds
UTGplus2: raises $0.15 to $0.15
Dealer: folds
Small Blind: folds
Big Blind: folds
Uncalled bet ($0.10) returned to UTGplus2
UTGplus2: doesn't show hand
UTGplus2 collected $0.12 from pot
*** SUMMARY ***
Total pot $0.12 | Rake $0.00
Seat 1: Hero showed
Seat 2: UTGplus1 showed
Seat 3: UTGplus2 won ($0.12)
Seat 4: Dealer (button) showed
Seat 5: Small Blind (small blind) showed
Seat 6: Big Blind (big blind) showed



PokerStars Zoom Hand #3434327606: Hold'em No Limit ($0.02/$0.05) - 2017/03/08 22:39:14
Table '#952' 6-max Seat #3 is the button
Seat 1: UTGplus1 ($3.47 in chips)
Seat 2: UTGplus2 ($1.54 in chips)
Seat 3: Hero ($11.28 in chips)
Seat 4: Small Blind ($4.53 in chips)
Seat 5: Big Blind ($1.31 in chips)
Seat 6: UTG ($0.81 in chips)
Small Blind: posts small blind $0.02
Big Blind: posts big blind $0.05
*** HOLE CARDS ***
Dealt to Hero [Js 3c]
UTG: folds
UTGplus1: folds
UTGplus2: folds
Hero: folds
Small Blind: folds
Big Blind: doesn't show hand
Big Blind collected $0.07 from pot
Table deposit $1.98 
*** SUMMARY ***
Total pot $0.07 | Rake $0.00
Seat 1: UTGplus1 showed
Seat 2: UTGplus2 showed
Seat 3: Hero (button) showed
Seat 4: Small Blind (small blind) showed
Seat 5: Big Blind (big blind) won ($0.07)
Seat 6: UTG showed



PokerStars Zoom Hand #3434327670: Hold'em No Limit ($0.02/$0.05) - 2017/03/08 22:39:20
Table '#952' 6-max Seat #6 is the button
Seat 1: Hero ($11.28 in chips)
Seat 2: Big Blind ($5 in chips)
Seat 3: UTG ($4.70 in chips)
Seat 4: UTGplus1 ($5 in chips)
Seat 5: UTGplus2 ($8.08 in chips)
Seat 6: Dealer ($12.44 in chips)
Hero: posts small blind $0.02
Big Blind: posts big blind $0.05
*** HOLE CARDS ***
Dealt to Hero [2c Tc]
UTG: folds
UTGplus1: folds
UTGplus2: folds
Dealer: folds
Hero: folds
Big Blind: doesn't show hand
Big Blind collected $0.07 from pot
*** SUMMARY ***
Total pot $0.07 | Rake $0.00
Seat 1: Hero (small blind) showed
Seat 2: Big Blind (big blind) won ($0.07)
Seat 3: UTG showed
Seat 4: UTGplus1 showed
Seat 5: UTGplus2 showed
Seat 6: Dealer (button) showed



PokerStars Zoom Hand #3434327728: Hold'em No Limit ($0.02/$0.05) - 2017/03/08 22:39:25
Table '#952' 6-max Seat #1 is the button
Seat 1: Dealer ($3 in chips)
Seat 2: Small Blind ($2.45 in chips)
Seat 3: Hero ($11.26 in chips)
Seat 4: UTG ($3.22 in chips)
Seat 5: UTGplus1 ($1.69 in chips)
Seat 6: UTGplus2 ($5.18 in chips)
Small Blind: posts small blind $0.02
Hero: posts big blind $0.05
*** HOLE CARDS ***
Dealt to Hero [3s Jd]
UTG: raises $0.42 to $0.42
UTGplus1: folds
UTGplus2: calls $0.42 
Dealer: folds
Small Blind: folds
Hero: folds
*** FLOP *** [Td 9d 4h]
UTG: bets $0.47 
UTGplus2: calls $0.47 
*** TURN *** [Td 9d 4h] [Ac]
UTG: bets $2.33 and is all-in
UTGplus2: calls $2.33 
*** RIVER *** [Td 9d 4h Ac] [4c]
*** SHOW DOWN ***
UTG: shows [8d 8s] (two pair, Eights and Aces)
UTGplus2: shows [Kd Kc] (two pair, Kings and Aces)
UTGplus2 collected $6.19 from pot
Table deposit $5 
Seat re-join
*** SUMMARY ***
Total pot $6.51 | Rake $0.32
Board [Td 9d 4h Ac 4c]
Seat 1: Dealer (button) showed
Seat 2: Small Blind (small blind) showed
Seat 3: Hero (big blind) showed
Seat 4: UTG showed [8d 8s] and lost with two pair, Eights and Aces
Seat 5: UTGplus1 showed
Seat 6: UTGplus2 showed [Kd Kc] and won ($6.19) with two pair, Kings and Aces



PokerStars Zoom Hand #3434327768: Hold'em No Limit ($0.02/$0.05) - 2017/03/08 22:39:30
Table '#952' 6-max Seat #3 is the button
Seat 1: UTGplus1 ($4.12 in chips)
Seat 2: UTGplus2 ($3.14 in chips)
Seat 3: Dealer ($13.43 in chips)
Seat 4: Hero ($11.21 in chips)
Seat 5: Big Blind ($21.32 in chips)
Seat 6: UTG ($10.69 in chips)
Hero: posts small blind $0.02
Big Blind: posts big blind $0.05
*** HOLE CARDS ***
Dealt to Hero [4d Th]
UTG: raises $0.16 to $0.16
UTGplus1: calls $0.16 
UTGplus2: folds
Dealer: calls $0.16 
Hero: folds
Big Blind: folds
*** FLOP *** [4c 4s 2h]
UTG: checks
UTGplus1: bets $0.27 
Dealer: folds
UTG: folds
Uncalled bet ($0.27) returned to UTGplus1
UTGplus1: doesn't show hand
UTGplus1 collected $0.53 from pot
*** SUMMARY ***
Total pot $0.55 | Rake $0.02
Board [4c 4s 2h]
Seat 1: UTGplus1 won ($0.53)
Seat 2: UTGplus2 showed
Seat 3: Dealer (button) showed
Seat 4: Hero (small blind) showed
Seat 5: Big Blind (big blind) showed
Seat 6: UTG showed



PokerStars Zoom Hand #3434327906: Hold'em No Limit ($0.02/$0.05) - 2017/03/08 22:39:46
Table '#952' 6-max Seat #1 is the button
Seat 1: Dealer ($2.93 in chips)
Seat 2: Hero ($11.19 in chips)
Seat 3: Big Blind ($5 in chips)
Seat 4: UTG ($11.69 in chips)
Seat 5: UTGplus1 ($4.53 in chips)
Seat 6: UTGplus2 ($5.38 in chips)
Hero: posts small blind $0.02
Big Blind: posts big blind $0.05
*** HOLE CARDS ***
Dealt to Hero [Ah 4d]
UTG: folds
UTGplus1: folds
UTGplus2: folds
Dealer: raises $0.15 to $0.15
Hero: folds
Big Blind: folds
Uncalled bet ($0.10) returned to Dealer
Dealer: doesn't show hand
Dealer collected $0.12 from pot
*** SUMMARY ***
Total pot $0.12 | Rake $0.00
Seat 1: Dealer (button) won ($0.12)
Seat 2: Hero (small blind) showed
Seat 3: Big Blind (big blind) showed
Seat 4: UTG showed
Seat 5: UTGplus1 showed
Seat 6: UTGplus2 showed



PokerStars Zoom Hand #3434328009: Hold'em No Limit ($0.02/$0.05) - 2017/03/08 22:39:58
Table '#952' 6-max Seat #5 is the button
Seat 1: Big Blind ($1.37 in chips)
Seat 2: UTG ($7.48 in chips)
Seat 3: UTGplus1 ($2.68 in chips)
Seat 4: Hero ($11.17 in chips)
Seat 5: Dealer ($4.15 in chips)
Seat 6: Small Blind ($6.40 in chips)
Small Blind: posts small blind $0.02
Big Blind: posts big blind $0.05
*** HOLE CARDS ***
Dealt to Hero [3c 6d]
UTG: folds
UTGplus1: folds
Hero: folds
Dealer: calls $0.05 
Small Blind: calls $0.03 
Big Blind: checks
*** FLOP *** [9s 9d 7h]
Small Blind: checks
Big Blind: bets $0.05 
Dealer: calls $0.05 
Small Blind: calls $0.05 
*** TURN *** [9s 9d 7h] [Ad]
Small Blind: checks
Big Blind: checks
Dealer: checks
*** RIVER *** [9s 9d 7h Ad] [Jd]
Small Blind: bets $0.15 
Big Blind: calls $0.15 
Dealer: folds
*** SHOW DOWN ***
Small Blind: shows [8h 9c] (three of a kind, Nines)
Big Blind: shows [7s Js] (Two pair)
Small Blind collected $0.57 from pot
*** SUMMARY ***
Total pot $0.6 | Rake $0.03
Board [9s 9d 7h Ad Jd]
Seat 1: Big Blind (big blind) showed [7s Js]
Seat 2: UTG showed
Seat 3: UTGplus1 showed
Seat 4: Hero showed
Seat 5: Dealer (button) showed
Seat 6: Small Blind (small blind) showed [8h 9c] and won ($0.57) with three of a kind, Nines



PokerStars Zoom Hand #3434328054: Hold'em No Limit ($0.02/$0.05) - 2017/03/08 22:40:03
Table '#952' 6-max Seat #3 is the button
Seat 1: UTGplus1 ($4.30 in chips)
Seat 2: UTGplus2 ($6.80 in chips)
Seat 3: Hero ($11.17 in chips)
Seat 4: Small Blind ($2.82 in chips)
Seat 5: Big Blind ($17.63 in chips)
Seat 6: UTG ($7.44 in chips)
Small Blind: posts small blind $0.02
Big Blind: posts big blind $0.05
*** HOLE CARDS ***
Dealt to Hero [3s 5s]
UTG: folds
UTGplus1: raises $0.15 to $0.15
UTGplus2: folds
Hero: folds
Small Blind: folds
Big Blind: raises $0.42 to $0.47
UTGplus1: folds
Uncalled bet ($0.32) returned to Big Blind
Big Blind: doesn't show hand
Big Blind collected $0.32 from pot
*** SUMMARY ***
Total pot $0.32 | Rake $0.00
Seat 1: UTGplus1 showed
Seat 2: UTGplus2 showed
Seat 3: Hero (button) showed
Seat 4: Small Blind (small blind) showed
Seat 5: Big Blind (big blind) won ($0.32)
Seat 6: UTG showed



PokerStars Zoom Hand #3434328146: Hold'em No Limit ($0.02/$0.05) - 2017/03/08 22:40:13
Table '#952' 6-max Seat #4 is the button
Seat 1: UTG ($8.15 in chips)
Seat 2: UTGplus1 ($2.62 in chips)
Seat 3: UTGplus2 ($4.95 in chips)
Seat 4: Dealer ($4.68 in chips)
Seat 5: Hero ($11.17 in chips)
Seat 6: Big Blind ($5.71 in chips)
Hero: posts small blind $0.02
Big Blind: posts big blind $0.05
*** HOLE CARDS ***
Dealt to Hero [Jd 2s]
UTG: folds
UTGplus1: folds
UTGplus2: calls $0.05 
Dealer: folds
Hero: folds
Big Blind: checks
*** FLOP *** [8h Ks 5h]
Big Blind: checks
UTGplus2: bets $0.05 
Big Blind: folds
Uncalled bet ($0.05) returned to UTGplus2
UTGplus2: doesn't show hand
UTGplus2 collected $0.12 from pot
*** SUMMARY ***
Total pot $0.12 | Rake $0.00
Board [8h Ks 5h]
Seat 1: UTG showed
Seat 2: UTGplus1 showed
Seat 3: UTGplus2 won ($0.12)
Seat 4: Dealer (button) showed
Seat 5: Hero (small blind) showed
Seat 6: Big Blind (big blind) showed



PokerStars Zoom Hand #3434328183: Hold'em No Limit ($0.02/$0.05) - 2017/03/08 22:40:18
Table '#952' 6-max Seat #4 is the button
Seat 1: UTG ($8.15 in chips)
Seat 2: UTGplus1 ($6.91 in chips)
Seat 3: UTGplus2 ($4.45 in chips)
Seat 4: Dealer ($2.80 in chips)
Seat 5: Small Blind ($6.82 in chips)
Seat 6: Hero ($11.15 in chips)
Small Blind: posts small blind $0.02
Hero: posts big blind $0.05
*** HOLE CARDS ***
Dealt to Hero [9c 6s]
UTG: folds
UTGplus1: raises $0.15 to $0.15
UTGplus2: folds
Dealer: folds
Small Blind: folds
Hero: folds
Uncalled bet ($0.10) returned to UTGplus1
UTGplus1: doesn't show hand
UTGplus1 collected $0.12 from pot
*** SUMMARY ***
Total pot $0.12 | Rake $0.00
Seat 1: UTG showed
Seat 2: UTGplus1 won ($0.12)
Seat 3: UTGplus2 showed
Seat 4: Dealer (button) showed
Seat 5: Small Blind (small blind) showed
Seat 6: Hero (big blind) showed



PokerStars Zoom Hand #3434328234: Hold'em No Limit ($0.02/$0.05) - 2017/03/08 22:40:24
Table '#952' 6-max Seat #2 is the button
Seat 1: Hero ($11.10 in chips)
Seat 2: Dealer ($2.88 in chips)
Seat 3: Small Blind ($5.66 in chips)
Seat 4: Big Blind ($3.42 in chips)
Seat 5: UTG ($5.12 in chips)
Seat 6: UTGplus1 ($6.80 in chips)
Small Blind: posts small blind $0.02
Big Blind: posts big blind $0.05
*** HOLE CARDS ***
Dealt to Hero [As 6d]
UTG: folds
UTGplus1: raises $0.15 to $0.15
Hero: folds
Dealer: folds
Small Blind: folds
Big Blind: folds
Uncalled bet ($0.10) returned to UTGplus1
UTGplus1: doesn't show hand
UTGplus1 collected $0.12 from pot
*** SUMMARY ***
Total pot $0.12 | Rake $0.00
Seat 1: Hero showed
Seat 2: Dealer (button) showed
Seat 3: Small Blind (small blind) showed
Seat 4: Big Blind (big blind) showed
Seat 5: UTG showed
Seat 6: UTGplus1 won ($0.12)



PokerStars Zoom Hand #3434328288: Hold'em No Limit ($0.02/$0.05) - 2017/03/08 22:40:29
Table '#952' 6-max Seat #5 is the button
Seat 1: Big Blind ($5 in chips)
Seat 2: UTG ($2.99 in chips)
Seat 3: Hero ($11.10 in chips)
Seat 4: UTGplus2 ($21.80 in chips)
Seat 5: Dealer ($2.85 in chips)
Seat 6: Small Blind ($5.96 in chips)
Small Blind: posts small blind $0.02
Big Blind: posts big blind $0.05
*** HOLE CARDS ***
Dealt to Hero [Ah 5h]
UTG: raises $0.17 to $0.17
Hero: calls $0.17 
UTGplus2: raises $0.75 to $0.75
Dealer: folds
Small Blind: raises $5.21 to $5.96 and is all-in
Big Blind: folds
UTG: calls $2.82 and is all-in
Hero: folds
UTGplus2: calls $5.21 
*** FLOP *** [3h 5s 5d]
*** TURN *** [3h 5s 5d] [Jc]
*** RIVER *** [3h 5s 5d Jc] [Tc]
*** SHOW DOWN ***
UTG: shows [9s 9d] (two pair, Nines and Jacks)
UTGplus2: shows [Ac Ad] (two pair, Aces and Jacks)
Small Blind: shows [6d 6h] (two pair, Sixs and Jacks)
UTGplus2 collected $5.65 from side pot
UTGplus2 collected $8.73 from main pot
*** SUMMARY ***
Total pot $15.13 | Rake $0.75
Board [3h 5s 5d Jc Tc]
Seat 1: Big Blind (big blind) showed
Seat 2: UTG showed [9s 9d] and lost with two pair, Nines and Jacks
Seat 3: Hero showed
Seat 4: UTGplus2 showed [Ac Ad] and won ($14.38) with two pair, Sixes and Jacks
Seat 5: Dealer (button) showed
Seat 6: Small Blind (small blind) showed [6d 6h] and lost with two pair, Sixes and Jacks



PokerStars Zoom Hand #3434328813: Hold'em No Limit ($0.02/$0.05) - 2017/03/08 22:41:30
Table '#952' 6-max Seat #4 is the button
Seat 1: Hero ($10.93 in chips)
Seat 2: UTGplus1 ($7.26 in chips)
Seat 3: UTGplus2 ($8.16 in chips)
Seat 4: Dealer ($3 in chips)
Seat 5: Small Blind ($5.27 in chips)
Seat 6: Big Blind ($5.65 in chips)
Small Blind: posts small blind $0.02
Big Blind: posts big blind $0.05
*** HOLE CARDS ***
Dealt to Hero [Qd 4h]
Hero: folds
UTGplus1: raises $0.10 to $0.10
UTGplus2: folds
Dealer: folds
Small Blind: folds
Big Blind: folds
Uncalled bet ($0.05) returned to UTGplus1
UTGplus1: doesn't show hand
UTGplus1 collected $0.12 from pot
*** SUMMARY ***
Total pot $0.12 | Rake $0.00
Seat 1: Hero showed
Seat 2: UTGplus1 won ($0.12)
Seat 3: UTGplus2 showed
Seat 4: Dealer (button) showed
Seat 5: Small Blind (small blind) showed
Seat 6: Big Blind (big blind) showed



PokerStars Zoom Hand #3434328868: Hold'em No Limit ($0.02/$0.05) - 2017/03/08 22:41:36
Table '#952' 6-max Seat #2 is the button
Seat 1: Hero ($10.93 in chips)
Seat 2: Dealer ($12.03 in chips)
Seat 3: Small Blind ($4.93 in chips)
Seat 4: Big Blind ($2.02 in chips)
Seat 5: UTG ($5.25 in chips)
Seat 6: UTGplus1 ($7.49 in chips)
Small Blind: posts small blind $0.02
Big Blind: posts big blind $0.05
*** HOLE CARDS ***
Dealt to Hero [5h 8s]
UTG: folds
UTGplus1: folds
Hero: folds
Dealer: raises $0.17 to $0.17
Small Blind: folds
Big Blind: folds
Uncalled bet ($0.12) returned to Dealer
Dealer: doesn't show hand
Dealer collected $0.12 from pot
*** SUMMARY ***
Total pot $0.12 | Rake $0.00
Seat 1: Hero showed
Seat 2: Dealer (button) won ($0.12)
Seat 3: Small Blind (small blind) showed
Seat 4: Big Blind (big blind) showed
Seat 5: UTG showed
Seat 6: UTGplus1 showed



PokerStars Zoom Hand #3434328893: Hold'em No Limit ($0.02/$0.05) - 2017/03/08 22:41:41
Table '#952' 6-max Seat #1 is the button
Seat 1: Dealer ($5.25 in chips)
Seat 2: Small Blind ($10.57 in chips)
Seat 3: Hero ($10.93 in chips)
Seat 4: UTG ($2.43 in chips)
Seat 5: UTGplus1 ($4.14 in chips)
Seat 6: UTGplus2 ($10.46 in chips)
Small Blind: posts small blind $0.02
Hero: posts big blind $0.05
*** HOLE CARDS ***
Dealt to Hero [Ac Kd]
UTG: folds
UTGplus1: folds
UTGplus2: folds
Dealer: folds
Small Blind: folds
Hero: doesn't show hand
Hero collected $0.07 from pot
*** SUMMARY ***
Total pot $0.07 | Rake $0.00
Seat 1: Dealer (button) showed
Seat 2: Small Blind (small blind) showed
Seat 3: Hero (big blind) won ($0.07)
Seat 4: UTG showed
Seat 5: UTGplus1 showed
Seat 6: UTGplus2 showed



PokerStars Zoom Hand #3434329049: Hold'em No Limit ($0.02/$0.05) - 2017/03/08 22:41:59
Table '#952' 6-max Seat #4 is the button
Seat 1: Hero ($10.95 in chips)
Seat 2: UTGplus1 ($30.12 in chips)
Seat 3: UTGplus2 ($8.72 in chips)
Seat 4: Dealer ($13.87 in chips)
Seat 5: Small Blind ($9.29 in chips)
Seat 6: Big Blind ($10.55 in chips)
Small Blind: posts small blind $0.02
Big Blind: posts big blind $0.05
*** HOLE CARDS ***
Dealt to Hero [4c Kd]
Hero: folds
UTGplus1: folds
UTGplus2: folds
Dealer: folds
Small Blind: raises $0.08 to $0.10
Big Blind: calls $0.05 
*** FLOP *** [Qs 5c Ah]
Small Blind: bets $0.10 
Big Blind: calls $0.10 
*** TURN *** [Qs 5c Ah] [9c]
Small Blind: bets $0.25 
Big Blind: folds
Uncalled bet ($0.25) returned to Small Blind
Small Blind: doesn't show hand
Small Blind collected $0.38 from pot
Table deposit $3.50 
Seat re-join
*** SUMMARY ***
Total pot $0.4 | Rake $0.02
Board [Qs 5c Ah 9c]
Seat 1: Hero showed
Seat 2: UTGplus1 showed
Seat 3: UTGplus2 showed
Seat 4: Dealer (button) showed
Seat 5: Small Blind (small blind) won ($0.38)
Seat 6: Big Blind (big blind) showed



PokerStars Zoom Hand #3434329088: Hold'em No Limit ($0.02/$0.05) - 2017/03/08 22:42:04
Table '#952' 6-max Seat #1 is the button
Seat 1: Dealer ($2.94 in chips)
Seat 2: Small Blind ($8.18 in chips)
Seat 3: Big Blind ($13.87 in chips)
Seat 4: UTG ($3.45 in chips)
Seat 5: Hero ($10.95 in chips)
Seat 6: UTGplus2 ($8.97 in chips)
Small Blind: posts small blind $0.02
Big Blind: posts big blind $0.05
*** HOLE CARDS ***
Dealt to Hero [Kd 8s]
UTG: raises $0.10 to $0.10
Hero: folds
UTGplus2: folds
Dealer: folds
Small Blind: folds
Big Blind: raises $0.27 to $0.32
UTG: raises $0.59 to $0.69
Big Blind: calls $0.37 
*** FLOP *** [Jd 6c 6d]
Big Blind: checks
UTG: bets $0.51 
Big Blind: raises $2.93 to $2.93
UTG: calls $2.25 and is all-in
*** TURN *** [Jd 6c 6d] [Kh]
*** RIVER *** [Jd 6c 6d Kh] [3s]
*** SHOW DOWN ***
Big Blind: shows [Jc Js] (a full house, Jacks full of Sixs)
UTG: shows [Ad Ah] (two pair, Aces and Kings)
Uncalled bet ($0.17) returned to Big Blind
Big Blind collected $6.58 from pot
*** SUMMARY ***
Total pot $6.92 | Rake $0.34
Board [Jd 6c 6d Kh 3s]
Seat 1: Dealer (button) showed
Seat 2: Small Blind (small blind) showed
Seat 3: Big Blind (big blind) showed [Jc Js] and won ($6.58) with a full house, Aces full of Kings
Seat 4: UTG showed [Ad Ah] and lost with two pair, Aces and Kings
Seat 5: Hero showed
Seat 6: UTGplus2 showed



PokerStars Zoom Hand #3434329138: Hold'em No Limit ($0.02/$0.05) - 2017/03/08 22:42:09
Table '#952' 6-max Seat #5 is the button
Seat 1: Big Blind ($2.41 in chips)
Seat 2: UTG ($5.59 in chips)
Seat 3: UTGplus1 ($8.97 in chips)
Seat 4: UTGplus2 ($8.72 in chips)
Seat 5: Hero ($10.95 in chips)
Seat 6: Small Blind ($7.49 in chips)
Small Blind: posts small blind $0.02
Big Blind: posts big blind $0.05
*** HOLE CARDS ***
Dealt to Hero [Jc 4s]
UTG: raises $0.15 to $0.15
UTGplus1: folds
UTGplus2: folds
Hero: folds
Small Blind: folds
Big Blind: folds
Uncalled bet ($0.10) returned to UTG
UTG: doesn't show hand
UTG collected $0.12 from pot
*** SUMMARY ***
Total pot $0.12 | Rake $0.00
Seat 1: Big Blind (big blind) showed
Seat 2: UTG won ($0.12)
Seat 3: UTGplus1 showed
Seat 4: UTGplus2 showed
Seat 5: Hero (button) showed
Seat 6: Small Blind (small blind) showed



PokerStars Zoom Hand #3434329187: Hold'em No Limit ($0.02/$0.05) - 2017/03/08 22:42:15
Table '#952' 6-max Seat #2 is the button
Seat 1: UTGplus2 ($6.08 in chips)
Seat 2: Dealer ($4.44 in chips)
Seat 3: Hero ($10.95 in chips)
Seat 4: Big Blind ($7.47 in chips)
Seat 5: UTG ($4.23 in chips)
Seat 6: UTGplus1 ($4.97 in chips)
Hero: posts small blind $0.02
Big Blind: posts big blind $0.05
*** HOLE CARDS ***
Dealt to Hero [2d 5c]
UTG: folds
UTGplus1: folds
UTGplus2: folds
Dealer: folds
Hero: folds
Big Blind: doesn't show hand
Big Blind collected $0.07 from pot
*** SUMMARY ***
Total pot $0.07 | Rake $0.00
Seat 1: UTGplus2 showed
Seat 2: Dealer (button) showed
Seat 3: Hero (small blind) showed
Seat 4: Big Blind (big blind) won ($0.07)
Seat 5: UTG showed
Seat 6: UTGplus1 showed



PokerStars Zoom Hand #3434329228: Hold'em No Limit ($0.02/$0.05) - 2017/03/08 22:42:20
Table '#952' 6-max Seat #2 is the button
Seat 1: UTGplus2 ($6.82 in chips)
Seat 2: Dealer ($4.23 in chips)
Seat 3: Hero ($10.93 in chips)
Seat 4: Big Blind ($3.62 in chips)
Seat 5: UTG ($3.25 in chips)
Seat 6: UTGplus1 ($4.41 in chips)
Hero: posts small blind $0.02
Big Blind: posts big blind $0.05
*** HOLE CARDS ***
Dealt to Hero [Ad Tc]
UTG: folds
UTGplus1: folds
UTGplus2: folds
Dealer: folds
Hero: raises $0.13 to $0.15
Big Blind: folds
Uncalled bet ($0.10) returned to Hero
Hero: doesn't show hand
Hero collected $0.1 from pot
*** SUMMARY ***
Total pot $0.1 | Rake $0.00
Seat 1: UTGplus2 showed
Seat 2: Dealer (button) showed
Seat 3: Hero (small blind) won ($0.1)
Seat 4: Big Blind (big blind) showed
Seat 5: UTG showed
Seat 6: UTGplus1 showed



PokerStars Zoom Hand #3434329409: Hold'em No Limit ($0.02/$0.05) - 2017/03/08 22:42:41
Table '#952' 6-max Seat #2 is the button
Seat 1: UTGplus2 ($2.41 in chips)
Seat 2: Dealer ($3.94 in chips)
Seat 3: Small Blind ($4.39 in chips)
Seat 4: Big Blind ($4.39 in chips)
Seat 5: UTG ($3.57 in chips)
Seat 6: Hero ($10.98 in chips)
Small Blind: posts small blind $0.02
Big Blind: posts big blind $0.05
*** HOLE CARDS ***
Dealt to Hero [Kh Qs]
UTG: folds
Hero: raises $0.17 to $0.17
UTGplus2: calls $0.17 
Dealer: folds
Small Blind: folds
Big Blind: calls $0.12 
*** FLOP *** [Ks 3d 4h]
Big Blind: checks
Hero: bets $0.31 
UTGplus2: folds
Big Blind: folds
Uncalled bet ($0.31) returned to Hero
Hero: doesn't show hand
Hero collected $0.51 from pot
*** SUMMARY ***
Total pot $0.53 | Rake $0.02
Board [Ks 3d 4h]
Seat 1: UTGplus2 showed
Seat 2: Dealer (button) showed
Seat 3: Small Blind (small blind) showed
Seat 4: Big Blind (big blind) showed
Seat 5: UTG showed
Seat 6: Hero won ($0.51)



PokerStars Zoom Hand #3434329700: Hold'em No Limit ($0.02/$0.05) - 2017/03/08 22:43:12
Table '#952' 6-max Seat #1 is the button
Seat 1: Dealer ($3.59 in chips)
Seat 2: Small Blind ($6.55 in chips)
Seat 3: Hero ($11.32 in chips)
Seat 4: UTG ($12.37 in chips)
Seat 5: UTGplus1 ($4.63 in chips)
Seat 6: UTGplus2 ($4.63 in chips)
Small Blind: posts small blind $0.02
Hero: posts big blind $0.05
*** HOLE CARDS ***
Dealt to Hero [2s 8h]
UTG: raises $0.15 to $0.15
UTGplus1: calls $0.15 
UTGplus2: folds
Dealer: folds
Small Blind: folds
Hero: folds
*** FLOP *** [Jd 9c As]
UTG: checks
UTGplus1: checks
*** TURN *** [Jd 9c As] [Th]
UTG: checks
UTGplus1: checks
*** RIVER *** [Jd 9c As Th] [Qc]
UTG: checks
UTGplus1: bets $0.37 
UTG: folds
Uncalled bet ($0.37) returned to UTGplus1
UTGplus1: doesn't show hand
UTGplus1 collected $0.36 from pot
*** SUMMARY ***
Total pot $0.37 | Rake $0.01
Board [Jd 9c As Th Qc]
Seat 1: Dealer (button) showed
Seat 2: Small Blind (small blind) showed
Seat 3: Hero (big blind) showed
Seat 4: UTG showed
Seat 5: UTGplus1 won ($0.36)
Seat 6: UTGplus2 showed



PokerStars Zoom Hand #3434329851: Hold'em No Limit ($0.02/$0.05) - 2017/03/08 22:43:30
Table '#952' 6-max Seat #5 is the button
Seat 1: Big Blind ($1.59 in chips)
Seat 2: UTG ($3.35 in chips)
Seat 3: UTGplus1 ($6.54 in chips)
Seat 4: UTGplus2 ($4.27 in chips)
Seat 5: Hero ($11.27 in chips)
Seat 6: Small Blind ($17.14 in chips)
Small Blind: posts small blind $0.02
Big Blind: posts big blind $0.05
*** HOLE CARDS ***
Dealt to Hero [3s 5c]
UTG: raises $0.17 to $0.17
UTGplus1: folds
UTGplus2: folds
Hero: folds
Small Blind: folds
Big Blind: folds
Uncalled bet ($0.12) returned to UTG
UTG: doesn't show hand
UTG collected $0.12 from pot
*** SUMMARY ***
Total pot $0.12 | Rake $0.00
Seat 1: Big Blind (big blind) showed
Seat 2: UTG won ($0.12)
Seat 3: UTGplus1 showed
Seat 4: UTGplus2 showed
Seat 5: Hero (button) showed
Seat 6: Small Blind (small blind) showed



PokerStars Zoom Hand #3434329902: Hold'em No Limit ($0.02/$0.05) - 2017/03/08 22:43:36
Table '#952' 6-max Seat #3 is the button
Seat 1: UTGplus1 ($10.59 in chips)
Seat 2: UTGplus2 ($5.29 in chips)
Seat 3: Dealer ($2.82 in chips)
Seat 4: Hero ($11.27 in chips)
Seat 5: Big Blind ($9.68 in chips)
Seat 6: UTG ($7.40 in chips)
Hero: posts small blind $0.02
Big Blind: posts big blind $0.05
*** HOLE CARDS ***
Dealt to Hero [Qd 7d]
UTG: folds
UTGplus1: raises $0.15 to $0.15
UTGplus2: folds
Dealer: calls $0.15 
Hero: folds
Big Blind: folds
*** FLOP *** [Ad 3c Qh]
UTGplus1: checks
Dealer: bets $0.05 
UTGplus1: calls $0.05 
*** TURN *** [Ad 3c Qh] [Tc]
UTGplus1: checks
Dealer: bets $0.25 
UTGplus1: calls $0.25 
*** RIVER *** [Ad 3c Qh Tc] [6c]
UTGplus1: checks
Dealer: bets $0.20 
UTGplus1: calls $0.20 
*** SHOW DOWN ***
Dealer: shows [Th As] (two pair, Aces and Queens)
UTGplus1: shows [9d 9c] (One pair)
Dealer collected $1.31 from pot
Table deposit $3.50 
*** SUMMARY ***
Total pot $1.37 | Rake $0.06
Board [Ad 3c Qh Tc 6c]
Seat 1: UTGplus1 showed [9d 9c]
Seat 2: UTGplus2 showed
Seat 3: Dealer (button) showed [Th As] and won ($1.31) with two pair, Aces and Queens
Seat 4: Hero (small blind) showed
Seat 5: Big Blind (big blind) showed
Seat 6: UTG showed



PokerStars Zoom Hand #3434330046: Hold'em No Limit ($0.02/$0.05) - 2017/03/08 22:43:52
Table '#952' 6-max Seat #1 is the button
Seat 1: Dealer ($4.48 in chips)
Seat 2: Small Blind ($7.44 in chips)
Seat 3: Big Blind ($2.83 in chips)
Seat 4: UTG ($8.60 in chips)
Seat 5: UTGplus1 ($3.42 in chips)
Seat 6: Hero ($11.25 in chips)
Small Blind: posts small blind $0.02
Big Blind: posts big blind $0.05
*** HOLE CARDS ***
Dealt to Hero [3c Kc]
UTG: folds
UTGplus1: folds
Hero: folds
Dealer: raises $0.10 to $0.10
Small Blind: folds
Big Blind: calls $0.05 
*** FLOP *** [Js Ah Qs]
Big Blind: bets $0.09 
Dealer: raises $0.18 to $0.18
Big Blind: folds
Uncalled bet ($0.09) returned to Dealer
Dealer: doesn't show hand
Dealer collected $0.38 from pot
*** SUMMARY ***
Total pot $0.4 | Rake $0.02
Board [Js Ah Qs]
Seat 1: Dealer (button) won ($0.38)
Seat 2: Small Blind (small blind) showed
Seat 3: Big Blind (big blind) showed
Seat 4: UTG showed
Seat 5: UTGplus1 showed
Seat 6: Hero showed



PokerStars Zoom Hand #3434330134: Hold'em No Limit ($0.02/$0.05) - 2017/03/08 22:44:01
Table '#952' 6-max Seat #6 is the button
Seat 1: Hero ($11.25 in chips)
Seat 2: Big Blind ($2.06 in chips)
Seat 3: UTG ($2.97 in chips)
Seat 4: UTGplus1 ($4.37 in chips)
Seat 5: UTGplus2 ($2.34 in chips)
Seat 6: Dealer ($12.22 in chips)
Hero: posts small blind $0.02
Big Blind: posts big blind $0.05
*** HOLE CARDS ***
Dealt to Hero [4d 2d]
UTG: folds
UTGplus1: folds
UTGplus2: raises $0.20 to $0.20
Dealer: folds
Hero: folds
Big Blind: calls $0.15 
*** FLOP *** [8s Qd Th]
Big Blind: checks
UTGplus2: checks
*** TURN *** [8s Qd Th] [2s]
Big Blind: checks
UTGplus2: bets $0.20 
Big Blind: calls $0.20 
*** RIVER *** [8s Qd Th 2s] [5d]
Big Blind: bets $0.41 
UTGplus2: raises $1.53 to $1.94 and is all-in
Big Blind: calls $1.25 and is all-in
*** SHOW DOWN ***
UTGplus2: shows [Jc 9d] (a straight, Eight to Queen)
Big Blind: shows [5h 5c] (Three of a kind)
Uncalled bet ($0.28) returned to UTGplus2
UTGplus2 collected $3.94 from pot
Table deposit $0.76 
*** SUMMARY ***
Total pot $4.14 | Rake $0.20
Board [8s Qd Th 2s 5d]
Seat 1: Hero (small blind) showed
Seat 2: Big Blind (big blind) showed [5h 5c]
Seat 3: UTG showed
Seat 4: UTGplus1 showed
Seat 5: UTGplus2 showed [Jc 9d] and won ($3.94) with a straight, Eight to Queen
Seat 6: Dealer (button) showed



PokerStars Zoom Hand #3434330288: Hold'em No Limit ($0.02/$0.05) - 2017/03/08 22:44:18
Table '#952' 6-max Seat #1 is the button
Seat 1: Dealer ($4.08 in chips)
Seat 2: Small Blind ($3.22 in chips)
Seat 3: Hero ($11.23 in chips)
Seat 4: UTG ($3.60 in chips)
Seat 5: UTGplus1 ($2.16 in chips)
Seat 6: UTGplus2 ($9.62 in chips)
Small Blind: posts small blind $0.02
Hero: posts big blind $0.05
*** HOLE CARDS ***
Dealt to Hero [9h 8h]
UTG: raises $0.15 to $0.15
UTGplus1: folds
UTGplus2: folds
Dealer: folds
Small Blind: folds
Hero: calls $0.10 
*** FLOP *** [5h Kd 6d]
Hero: checks
UTG: checks
*** TURN *** [5h Kd 6d] [Jc]
Hero: checks
UTG: bets $0.15 
Hero: folds
*** SHOW DOWN ***
UTG: shows [Ah Jd] (a pair of Jacks)
Uncalled bet ($0.15) returned to UTG
UTG collected $0.31 from pot
*** SUMMARY ***
Total pot $0.32 | Rake $0.01
Board [5h Kd 6d Jc]
Seat 1: Dealer (button) showed
Seat 2: Small Blind (small blind) showed
Seat 3: Hero (big blind) showed
Seat 4: UTG showed [Ah Jd] and won ($0.31) with a pair of Jacks
Seat 5: UTGplus1 showed
Seat 6: UTGplus2 showed



PokerStars Zoom Hand #3434330620: Hold'em No Limit ($0.02/$0.05) - 2017/03/08 22:44:58
Table '#952' 6-max Seat #6 is the button
Seat 1: Small Blind ($9.10 in chips)
Seat 2: Big Blind ($4.36 in chips)
Seat 3: UTG ($6.93 in chips)
Seat 4: Hero ($11.08 in chips)
Seat 5: UTGplus2 ($5 in chips)
Seat 6: Dealer ($10.68 in chips)
Small Blind: posts small blind $0.02
Big Blind: posts big blind $0.05
*** HOLE CARDS ***
Dealt to Hero [Qc Qd]
UTG: folds
Hero: raises $0.17 to $0.17
UTGplus2: folds
Dealer: folds
Small Blind: raises $0.42 to $0.44
Big Blind: folds
Hero: raises $1.20 to $1.37
Small Blind: folds
Uncalled bet ($0.93) returned to Hero
Hero: doesn't show hand
Hero collected $0.93 from pot
Table deposit $2.50 
Seat re-join
*** SUMMARY ***
Total pot $0.93 | Rake $0.00
Seat 1: Small Blind (small blind) showed
Seat 2: Big Blind (big blind) showed
Seat 3: UTG showed
Seat 4: Hero won ($0.93)
Seat 5: UTGplus2 showed
Seat 6: Dealer (button) showed



PokerStars Zoom Hand #3434331049: Hold'em No Limit ($0.02/$0.05) - 2017/03/08 22:45:47
Table '#952' 6-max Seat #4 is the button
Seat 1: Hero ($11.57 in chips)
Seat 2: UTGplus1 ($3.79 in chips)
Seat 3: UTGplus2 ($7.99 in chips)
Seat 4: Dealer ($2.16 in chips)
Seat 5: Small Blind ($5.49 in chips)
Seat 6: Big Blind ($3.62 in chips)
Small Blind: posts small blind $0.02
Big Blind: posts big blind $0.05
*** HOLE CARDS ***
Dealt to Hero [Jc 4c]
Hero: folds
UTGplus1: folds
UTGplus2: folds
Dealer: raises $0.15 to $0.15
Small Blind: raises $0.85 to $0.87
Big Blind: folds
Dealer: folds
Uncalled bet ($0.72) returned to Small Blind
Small Blind: doesn't show hand
Small Blind collected $0.35 from pot
*** SUMMARY ***
Total pot $0.35 | Rake $0.00
Seat 1: Hero showed
Seat 2: UTGplus1 showed
Seat 3: UTGplus2 showed
Seat 4: Dealer (button) showed
Seat 5: Small Blind (small blind) won ($0.35)
Seat 6: Big Blind (big blind) showed



PokerStars Zoom Hand #3434331098: Hold'em No Limit ($0.02/$0.05) - 2017/03/08 22:45:52
Table '#952' 6-max Seat #5 is the button
Seat 1: Big Blind ($3.79 in chips)
Seat 2: UTG ($7.99 in chips)
Seat 3: UTGplus1 ($8.31 in chips)
Seat 4: UTGplus2 ($7.88 in chips)
Seat 5: Dealer ($5.53 in chips)
Seat 6: Hero ($11.57 in chips)
Hero: posts small blind $0.02
Big Blind: posts big blind $0.05
*** HOLE CARDS ***
Dealt to Hero [Jc 2s]
UTG: folds
UTGplus1: folds
UTGplus2: folds
Dealer: folds
Hero: folds
Big Blind: doesn't show hand
Big Blind collected $0.07 from pot
*** SUMMARY ***
Total pot $0.07 | Rake $0.00
Seat 1: Big Blind (big blind) won ($0.07)
Seat 2: UTG showed
Seat 3: UTGplus1 showed
Seat 4: UTGplus2 showed
Seat 5: Dealer (button) showed
Seat 6: Hero (small blind) showed



PokerStars Zoom Hand #3434331150: Hold'em No Limit ($0.02/$0.05) - 2017/03/08 22:45:58
Table '#952' 6-max Seat #3 is the button
Seat 1: Hero ($11.55 in chips)
Seat 2: UTGplus2 ($5.36 in chips)
Seat 3: Dealer ($21.58 in chips)
Seat 4: Small Blind ($22.27 in chips)
Seat 5: Big Blind ($3.19 in chips)
Seat 6: UTG ($7.78 in chips)
Small Blind: posts small blind $0.02
Big Blind: posts big blind $0.05
*** HOLE CARDS ***
Dealt to Hero [9c 7c]
UTG: folds
Hero: raises $0.17 to $0.17
UTGplus2: folds
Dealer: folds
Small Blind: calls $0.15 
Big Blind: folds
*** FLOP *** [3c Ks 9s]
Small Blind: checks
Hero: bets $0.24 
Small Blind: calls $0.24 
*** TURN *** [3c Ks 9s] [5h]
Small Blind: checks
Hero: checks
*** RIVER *** [3c Ks 9s 5h] [Th]
Small Blind: checks
Hero: checks
*** SHOW DOWN ***
Small Blind: shows [4s 5s] (a pair of Fives)
Hero: shows [9c 7c] (a pair of Nines)
Hero collected $0.83 from pot
*** SUMMARY ***
Total pot $0.87 | Rake $0.04
Board [3c Ks 9s 5h Th]
Seat 1: Hero showed [9c 7c] and won ($0.83) with a pair of Nines
Seat 2: UTGplus2 showed
Seat 3: Dealer (button) showed
Seat 4: Small Blind (small blind) showed [4s 5s] and lost with a pair of Fives
Seat 5: Big Blind (big blind) showed
Seat 6: UTG showed



PokerStars Zoom Hand #3434331554: Hold'em No Limit ($0.02/$0.05) - 2017/03/08 22:46:48
Table '#952' 6-max Seat #1 is the button
Seat 1: Dealer ($10.54 in chips)
Seat 2: Small Blind ($8.54 in chips)
Seat 3: Hero ($11.97 in chips)
Seat 4: UTG ($21.86 in chips)
Seat 5: UTGplus1 ($11.16 in chips)
Seat 6: UTGplus2 ($4.56 in chips)
Small Blind: posts small blind $0.02
Hero: posts big blind $0.05
*** HOLE CARDS ***
Dealt to Hero [2s Jd]
UTG: calls $0.05 
UTGplus1: raises $0.20 to $0.20
UTGplus2: folds
Dealer: folds
Small Blind: folds
Hero: folds
UTG: calls $0.15 
*** FLOP *** [7s 6s 4h]
UTG: bets $0.15 
UTGplus1: calls $0.15 
*** TURN *** [7s 6s 4h] [3c]
UTG: bets $0.45 
UTGplus1: calls $0.45 
*** RIVER *** [7s 6s 4h 3c] [6h]
UTG: bets $21.06 and is all-in
UTGplus1: folds
Uncalled bet ($21.06) returned to UTG
UTG: doesn't show hand
UTG collected $1.59 from pot
*** SUMMARY ***
Total pot $1.67 | Rake $0.08
Board [7s 6s 4h 3c 6h]
Seat 1: Dealer (button) showed
Seat 2: Small Blind (small blind) showed
Seat 3: Hero (big blind) showed
Seat 4: UTG won ($1.59)
Seat 5: UTGplus1 showed
Seat 6: UTGplus2 showed



PokerStars Zoom Hand #3434331727: Hold'em No Limit ($0.02/$0.05) - 2017/03/08 22:47:09
Table '#952' 6-max Seat #2 is the button
Seat 1: UTGplus2 ($4.81 in chips)
Seat 2: Hero ($11.92 in chips)
Seat 3: Small Blind ($4.95 in chips)
Seat 4: Big Blind ($12.48 in chips)
Seat 5: UTG ($5 in chips)
Seat 6: UTGplus1 ($12.11 in chips)
Small Blind: posts small blind $0.02
Big Blind: posts big blind $0.05
*** HOLE CARDS ***
Dealt to Hero [3h As]
UTG: folds
UTGplus1: folds
UTGplus2: raises $0.10 to $0.10
Hero: folds
Small Blind: folds
Big Blind: folds
Uncalled bet ($0.05) returned to UTGplus2
UTGplus2: doesn't show hand
UTGplus2 collected $0.12 from pot
*** SUMMARY ***
Total pot $0.12 | Rake $0.00
Seat 1: UTGplus2 won ($0.12)
Seat 2: Hero (button) showed
Seat 3: Small Blind (small blind) showed
Seat 4: Big Blind (big blind) showed
Seat 5: UTG showed
Seat 6: UTGplus1 showed



PokerStars Zoom Hand #3434331773: Hold'em No Limit ($0.02/$0.05) - 2017/03/08 22:47:15
Table '#952' 6-max Seat #5 is the button
Seat 1: Big Blind ($10.05 in chips)
Seat 2: UTG ($4.88 in chips)
Seat 3: UTGplus1 ($7.41 in chips)
Seat 4: UTGplus2 ($7.11 in chips)
Seat 5: Hero ($11.92 in chips)
Seat 6: Small Blind ($3.24 in chips)
Small Blind: posts small blind $0.02
Big Blind: posts big blind $0.05
*** HOLE CARDS ***
Dealt to Hero [2s 7d]
UTG: folds
UTGplus1: folds
UTGplus2: folds
Hero: folds
Small Blind: folds
Big Blind: doesn't show hand
Big Blind collected $0.07 from pot
*** SUMMARY ***
Total pot $0.07 | Rake $0.00
Seat 1: Big Blind (big blind) won ($0.07)
Seat 2: UTG showed
Seat 3: UTGplus1 showed
Seat 4: UTGplus2 showed
Seat 5: Hero (button) showed
Seat 6: Small Blind (small blind) showed



PokerStars Zoom Hand #3434331813: Hold'em No Limit ($0.02/$0.05) - 2017/03/08 22:47:20
Table '#952' 6-max Seat #2 is the button
Seat 1: UTGplus2 ($10.32 in chips)
Seat 2: Dealer ($7.41 in chips)
Seat 3: Small Blind ($3.85 in chips)
Seat 4: Big Blind ($5 in chips)
Seat 5: UTG ($12.06 in chips)
Seat 6: Hero ($11.92 in chips)
Small Blind: posts small blind $0.02
Big Blind: posts big blind $0.05
*** HOLE CARDS ***
Dealt to Hero [As 6d]
UTG: raises $0.15 to $0.15
Hero: folds
UTGplus2: folds
Dealer: folds
Small Blind: folds
Big Blind: folds
Uncalled bet ($0.10) returned to UTG
UTG: doesn't show hand
UTG collected $0.12 from pot
*** SUMMARY ***
Total pot $0.12 | Rake $0.00
Seat 1: UTGplus2 showed
Seat 2: Dealer (button) showed
Seat 3: Small Blind (small blind) showed
Seat 4: Big Blind (big blind) showed
Seat 5: UTG won ($0.12)
Seat 6: Hero showed



PokerStars Zoom Hand #3434331859: Hold'em No Limit ($0.02/$0.05) - 2017/03/08 22:47:25
Table '#952' 6-max Seat #6 is the button
Seat 1: Small Blind ($4.61 in chips)
Seat 2: Big Blind ($1.29 in chips)
Seat 3: UTG ($5.54 in chips)
Seat 4: UTGplus1 ($1.85 in chips)
Seat 5: Hero ($11.92 in chips)
Seat 6: Dealer ($3.31 in chips)
Small Blind: posts small blind $0.02
Big Blind: posts big blind $0.05
*** HOLE CARDS ***
Dealt to Hero [Js Jd]
UTG: folds
UTGplus1: folds
Hero: raises $0.17 to $0.17
Dealer: folds
Small Blind: folds
Big Blind: raises $0.44 to $0.49
Hero: raises $1.32 to $1.49
Big Blind: calls $0.80 and is all-in
*** FLOP *** [Jc Qc Qh]
*** TURN *** [Jc Qc Qh] [8c]
*** RIVER *** [Jc Qc Qh 8c] [5c]
*** SHOW DOWN ***
Big Blind: shows [6c 6h] (a flush, Queen high)
Hero: shows [Js Jd] (a full house, Jacks full of Queens)
Uncalled bet ($0.20) returned to Hero
Hero collected $2.47 from pot
*** SUMMARY ***
Total pot $2.6 | Rake $0.13
Board [Jc Qc Qh 8c 5c]
Seat 1: Small Blind (small blind) showed
Seat 2: Big Blind (big blind) showed [6c 6h] and lost with a flush, Queen high
Seat 3: UTG showed
Seat 4: UTGplus1 showed
Seat 5: Hero showed [Js Jd] and won ($2.47) with a full house, Jacks full of Queens
Seat 6: Dealer (button) showed



PokerStars Zoom Hand #3434332238: Hold'em No Limit ($0.02/$0.05) - 2017/03/08 22:48:11
Table '#952' 6-max Seat #4 is the button
Seat 1: UTG ($7.94 in chips)
Seat 2: UTGplus1 ($5.89 in chips)
Seat 3: UTGplus2 ($21.08 in chips)
Seat 4: Dealer ($2.79 in chips)
Seat 5: Hero ($13.10 in chips)
Seat 6: Big Blind ($4.78 in chips)
Hero: posts small blind $0.02
Big Blind: posts big blind $0.05
*** HOLE CARDS ***
Dealt to Hero [5c 4s]
UTG: folds
UTGplus1: folds
UTGplus2: folds
Dealer: folds
Hero: folds
Big Blind: doesn't show hand
Big Blind collected $0.07 from pot
Table deposit $5 
Seat re-join
*** SUMMARY ***
Total pot $0.07 | Rake $0.00
Seat 1: UTG showed
Seat 2: UTGplus1 showed
Seat 3: UTGplus2 showed
Seat 4: Dealer (button) showed
Seat 5: Hero (small blind) showed
Seat 6: Big Blind (big blind) won ($0.07)



PokerStars Zoom Hand #3434332368: Hold'em No Limit ($0.02/$0.05) - 2017/03/08 22:48:26
Table '#952' 6-max Seat #2 is the button
Seat 1: UTGplus2 ($6.28 in chips)
Seat 2: Dealer ($11.22 in chips)
Seat 3: Hero ($13.08 in chips)
Seat 4: Big Blind ($10.47 in chips)
Seat 5: UTG ($4.47 in chips)
Seat 6: UTGplus1 ($5.89 in chips)
Hero: posts small blind $0.02
Big Blind: posts big blind $0.05
*** HOLE CARDS ***
Dealt to Hero [Kc Js]
UTG: folds
UTGplus1: calls $0.05 
UTGplus2: folds
Dealer: folds
Hero: raises $0.18 to $0.20
Big Blind: folds
UTGplus1: calls $0.15 
*** FLOP *** [Ks 4d Ts]
Hero: bets $0.27 
UTGplus1: folds
Uncalled bet ($0.27) returned to Hero
Hero: doesn't show hand
Hero collected $0.43 from pot
*** SUMMARY ***
Total pot $0.45 | Rake $0.02
Board [Ks 4d Ts]
Seat 1: UTGplus2 showed
Seat 2: Dealer (button) showed
Seat 3: Hero (small blind) won ($0.43)
Seat 4: Big Blind (big blind) showed
Seat 5: UTG showed
Seat 6: UTGplus1 showed



PokerStars Zoom Hand #3434332743: Hold'em No Limit ($0.02/$0.05) - 2017/03/08 22:49:09
Table '#952' 6-max Seat #1 is the button
Seat 1: Dealer ($4.95 in chips)
Seat 2: Small Blind ($3.96 in chips)
Seat 3: Hero ($13.31 in chips)
Seat 4: UTG ($3.83 in chips)
Seat 5: UTGplus1 ($5.42 in chips)
Seat 6: UTGplus2 ($5.69 in chips)
Small Blind: posts small blind $0.02
Hero: posts big blind $0.05
*** HOLE CARDS ***
Dealt to Hero [6h 9d]
UTG: folds
UTGplus1: folds
UTGplus2: folds
Dealer: folds
Small Blind: calls $0.03 
Hero: checks
*** FLOP *** [Ad Qh Ac]
Small Blind: checks
Hero: checks
*** TURN *** [Ad Qh Ac] [Qd]
Small Blind: bets $0.05 
Hero: folds
Uncalled bet ($0.05) returned to Small Blind
Small Blind: doesn't show hand
Small Blind collected $0.1 from pot
*** SUMMARY ***
Total pot $0.1 | Rake $0.00
Board [Ad Qh Ac Qd]
Seat 1: Dealer (button) showed
Seat 2: Small Blind (small blind) won ($0.1)
Seat 3: Hero (big blind) showed
Seat 4: UTG showed
Seat 5: UTGplus1 showed
Seat 6: UTGplus2 showed



PokerStars Zoom Hand #3434332994: Hold'em No Limit ($0.02/$0.05) - 2017/03/08 22:49:39
Table '#952' 6-max Seat #2 is the button
Seat 1: UTGplus2 ($5.01 in chips)
Seat 2: Dealer ($5.64 in chips)
Seat 3: Hero ($13.26 in chips)
Seat 4: Big Blind ($10.28 in chips)
Seat 5: UTG ($1.78 in chips)
Seat 6: UTGplus1 ($4.95 in chips)
Hero: posts small blind $0.02
Big Blind: posts big blind $0.05
*** HOLE CARDS ***
Dealt to Hero [7c 5d]
UTG: raises $0.10 to $0.10
UTGplus1: folds
UTGplus2: folds
Dealer: folds
Hero: folds
Big Blind: folds
Uncalled bet ($0.05) returned to UTG
UTG: doesn't show hand
UTG collected $0.12 from pot
*** SUMMARY ***
Total pot $0.12 | Rake $0.00
Seat 1: UTGplus2 showed
Seat 2: Dealer (button) showed
Seat 3: Hero (small blind) showed
Seat 4: Big Blind (big blind) showed
Seat 5: UTG won ($0.12)
Seat 6: UTGplus1 showed



PokerStars Zoom Hand #3434333059: Hold'em No Limit ($0.02/$0.05) - 2017/03/08 22:49:46
Table '#952' 6-max Seat #3 is the button
Seat 1: UTGplus1 ($2.07 in chips)
Seat 2: UTGplus2 ($12.64 in chips)
Seat 3: Dealer ($12 in chips)
Seat 4: Small Blind ($2.81 in chips)
Seat 5: Big Blind ($1.89 in chips)
Seat 6: Hero ($13.24 in chips)
Small Blind: posts small blind $0.02
Big Blind: posts big blind $0.05
*** HOLE CARDS ***
Dealt to Hero [9d 6d]
Hero: raises $0.17 to $0.17
UTGplus1: folds
UTGplus2: folds
Dealer: calls $0.17 
Small Blind: calls $0.15 
Big Blind: calls $0.12 
*** FLOP *** [8d 4c Th]
Small Blind: checks
Big Blind: checks
Hero: bets $0.39 
Dealer: calls $0.39 
Small Blind: folds
Big Blind: calls $0.39 
*** TURN *** [8d 4c Th] [Jd]
Big Blind: checks
Hero: checks
Dealer: bets $0.65 
Big Blind: raises $0.68 to $1.33 and is all-in
Hero: folds
Dealer: calls $0.68 
*** RIVER *** [8d 4c Th Jd] [As]
*** SHOW DOWN ***
Dealer: shows [Qc Qd] (a pair of Queens)
Big Blind: shows [Ac Jc] (two pair, Aces and Tens)
Big Blind collected $4.29 from pot
*** SUMMARY ***
Total pot $4.51 | Rake $0.22
Board [8d 4c Th Jd As]
Seat 1: UTGplus1 showed
Seat 2: UTGplus2 showed
Seat 3: Dealer (button) showed [Qc Qd] and lost with a pair of Queens
Seat 4: Small Blind (small blind) showed
Seat 5: Big Blind (big blind) showed [Ac Jc] and won ($4.29) with two pair, Aces and Tens
Seat 6: Hero showed



PokerStars Zoom Hand #3434333663: Hold'em No Limit ($0.02/$0.05) - 2017/03/08 22:50:59
Table '#952' 6-max Seat #4 is the button
Seat 1: UTG ($4.78 in chips)
Seat 2: Hero ($12.68 in chips)
Seat 3: UTGplus2 ($2.62 in chips)
Seat 4: Dealer ($5.68 in chips)
Seat 5: Small Blind ($11.09 in chips)
Seat 6: Big Blind ($2.31 in chips)
Small Blind: posts small blind $0.02
Big Blind: posts big blind $0.05
*** HOLE CARDS ***
Dealt to Hero [3h 4h]
UTG: folds
Hero: folds
UTGplus2: folds
Dealer: raises $0.10 to $0.10
Small Blind: folds
Big Blind: folds
Uncalled bet ($0.05) returned to Dealer
Dealer: doesn't show hand
Dealer collected $0.12 from pot
*** SUMMARY ***
Total pot $0.12 | Rake $0.00
Seat 1: UTG showed
Seat 2: Hero showed
Seat 3: UTGplus2 showed
Seat 4: Dealer (button) won ($0.12)
Seat 5: Small Blind (small blind) showed
Seat 6: Big Blind (big blind) showed



PokerStars Zoom Hand #3434333750: Hold'em No Limit ($0.02/$0.05) - 2017/03/08 22:51:09
Table '#952' 6-max Seat #3 is the button
Seat 1: Hero ($12.68 in chips)
Seat 2: UTGplus2 ($2.72 in chips)
Seat 3: Dealer ($1.72 in chips)
Seat 4: Small Blind ($7.95 in chips)
Seat 5: Big Blind ($9.30 in chips)
Seat 6: UTG ($7.98 in chips)
Small Blind: posts small blind $0.02
Big Blind: posts big blind $0.05
*** HOLE CARDS ***
Dealt to Hero [5s Ks]
UTG: raises $0.10 to $0.10
Hero: folds
UTGplus2: raises $0.37 to $0.37
Dealer: folds
Small Blind: folds
Big Blind: calls $0.32 
UTG: folds
*** FLOP *** [Ts 4s 2h]
Big Blind: bets $0.86 
UTGplus2: folds
Uncalled bet ($0.86) returned to Big Blind
Big Blind: doesn't show hand
Big Blind collected $0.82 from pot
*** SUMMARY ***
Total pot $0.86 | Rake $0.04
Board [Ts 4s 2h]
Seat 1: Hero showed
Seat 2: UTGplus2 showed
Seat 3: Dealer (button) showed
Seat 4: Small Blind (small blind) showed
Seat 5: Big Blind (big blind) won ($0.82)
Seat 6: UTG showed



PokerStars Zoom Hand #3434333807: Hold'em No Limit ($0.02/$0.05) - 2017/03/08 22:51:16
Table '#952' 6-max Seat #1 is the button
Seat 1: Hero ($12.68 in chips)
Seat 2: Small Blind ($3.82 in chips)
Seat 3: Big Blind ($5 in chips)
Seat 4: UTG ($1.80 in chips)
Seat 5: UTGplus1 ($10.11 in chips)
Seat 6: UTGplus2 ($3.26 in chips)
Small Blind: posts small blind $0.02
Big Blind: posts big blind $0.05
*** HOLE CARDS ***
Dealt to Hero [7c Qd]
UTG: folds
UTGplus1: folds
UTGplus2: raises $0.30 to $0.30
Hero: folds
Small Blind: folds
Big Blind: folds
Uncalled bet ($0.25) returned to UTGplus2
UTGplus2: doesn't show hand
UTGplus2 collected $0.12 from pot
*** SUMMARY ***
Total pot $0.12 | Rake $0.00
Seat 1: Hero (button) showed
Seat 2: Small Blind (small blind) showed
Seat 3: Big Blind (big blind) showed
Seat 4: UTG showed
Seat 5: UTGplus1 showed
Seat 6: UTGplus2 won ($0.12)



PokerStars Zoom Hand #3434333849: Hold'em No Limit ($0.02/$0.05) - 2017/03/08 22:51:21
Table '#952' 6-max Seat #5 is the button
Seat 1: Big Blind ($5.48 in chips)
Seat 2: UTG ($10.11 in chips)
Seat 3: Hero ($12.68 in chips)
Seat 4: UTGplus2 ($4.06 in chips)
Seat 5: Dealer ($4.91 in chips)
Seat 6: Small Blind ($4.90 in chips)
Small Blind: posts small blind $0.02
Big Blind: posts big blind $0.05
*** HOLE CARDS ***
Dealt to Hero [8c Td]
UTG: folds
Hero: folds
UTGplus2: folds
Dealer: folds
Small Blind: raises $0.13 to $0.15
Big Blind: calls $0.10 
*** FLOP *** [7s Ad Th]
Small Blind: bets $0.15 
Big Blind: folds
Uncalled bet ($0.15) returned to Small Blind
Small Blind: doesn't show hand
Small Blind collected $0.29 from pot
Table leave user
Table deposit $2.50 
*** SUMMARY ***
Total pot $0.3 | Rake $0.01
Board [7s Ad Th]
Seat 1: Big Blind (big blind) showed
Seat 2: UTG showed
Seat 3: Hero showed
Seat 4: UTGplus2 showed
Seat 5: Dealer (button) showed
Seat 6: Small Blind (small blind) won ($0.29)



PokerStars Zoom Hand #3434333898: Hold'em No Limit ($0.02/$0.05) - 2017/03/08 22:51:26
Table '#952' 6-max Seat #5 is the button
Seat 1: Hero ($12.68 in chips)
Seat 2: UTG ($6.29 in chips)
Seat 3: UTGplus1 ($12.45 in chips)
Seat 4: UTGplus2 ($4.74 in chips)
Seat 5: Dealer ($8.72 in chips)
Seat 6: Small Blind ($12.06 in chips)
Small Blind: posts small blind $0.02
Hero: posts big blind $0.05
*** HOLE CARDS ***
Dealt to Hero [6c 2h]
UTG: folds
UTGplus1: folds
UTGplus2: folds
Dealer: folds
Small Blind: folds
Hero: doesn't show hand
Hero collected $0.07 from pot
*** SUMMARY ***
Total pot $0.07 | Rake $0.00
Seat 1: Hero (big blind) won ($0.07)
Seat 2: UTG showed
Seat 3: UTGplus1 showed
Seat 4: UTGplus2 showed
Seat 5: Dealer (button) showed
Seat 6: Small Blind (small blind) showed



PokerStars Zoom Hand #3434334006: Hold'em No Limit ($0.02/$0.05) - 2017/03/08 22:51:40
Table '#952' 6-max Seat #1 is the button
Seat 1: Dealer ($5.47 in chips)
Seat 2: Small Blind ($7.55 in chips)
Seat 3: Big Blind ($8.14 in chips)
Seat 4: Hero ($12.70 in chips)
Seat 5: UTGplus1 ($2.50 in chips)
Seat 6: UTGplus2 ($5.63 in chips)
Small Blind: posts small blind $0.02
Big Blind: posts big blind $0.05
*** HOLE CARDS ***
Dealt to Hero [4s Ks]
Hero: folds
UTGplus1: folds
UTGplus2: folds
Dealer: folds
Small Blind: raises $0.13 to $0.15
Big Blind: folds
Uncalled bet ($0.10) returned to Small Blind
Small Blind: doesn't show hand
Small Blind collected $0.1 from pot
Table leave user
Table deposit $3.69 
*** SUMMARY ***
Total pot $0.1 | Rake $0.00
Seat 1: Dealer (button) showed
Seat 2: Small Blind (small blind) won ($0.1)
Seat 3: Big Blind (big blind) showed
Seat 4: Hero showed
Seat 5: UTGplus1 showed
Seat 6: UTGplus2 showed



PokerStars Zoom Hand #3434334054: Hold'em No Limit ($0.02/$0.05) - 2017/03/08 22:51:46
Table '#952' 6-max Seat #3 is the button
Seat 1: UTGplus1 ($8.09 in chips)
Seat 2: UTGplus2 ($5.33 in chips)
Seat 3: Hero ($12.70 in chips)
Seat 4: Small Blind ($4.66 in chips)
Seat 5: Big Blind ($3.31 in chips)
Seat 6: UTG ($8.52 in chips)
Small Blind: posts small blind $0.02
Big Blind: posts big blind $0.05
*** HOLE CARDS ***
Dealt to Hero [Ad 4h]
UTG: folds
UTGplus1: folds
UTGplus2: folds
Hero: raises $0.17 to $0.17
Small Blind: calls $0.15 
Big Blind: calls $0.12 
*** FLOP *** [9c 7d 9s]
Small Blind: checks
Big Blind: checks
Hero: checks
*** TURN *** [9c 7d 9s] [Jc]
Small Blind: checks
Big Blind: bets $0.20 
Hero: folds
Small Blind: folds
Uncalled bet ($0.20) returned to Big Blind
Big Blind: doesn't show hand
Big Blind collected $0.49 from pot
*** SUMMARY ***
Total pot $0.51 | Rake $0.02
Board [9c 7d 9s Jc]
Seat 1: UTGplus1 showed
Seat 2: UTGplus2 showed
Seat 3: Hero (button) showed
Seat 4: Small Blind (small blind) showed
Seat 5: Big Blind (big blind) won ($0.49)
Seat 6: UTG showed



PokerStars Zoom Hand #3434334459: Hold'em No Limit ($0.02/$0.05) - 2017/03/08 22:52:34
Table '#952' 6-max Seat #4 is the button
Seat 1: Hero ($12.53 in chips)
Seat 2: UTGplus1 ($2.54 in chips)
Seat 3: UTGplus2 ($3.52 in chips)
Seat 4: Dealer ($14.04 in chips)
Seat 5: Small Blind ($3.65 in chips)
Seat 6: Big Blind ($3.75 in chips)
Small Blind: posts small blind $0.02
Big Blind: posts big blind $0.05
*** HOLE CARDS ***
Dealt to Hero [5s Tc]
Hero: folds
UTGplus1: raises $0.10 to $0.10
UTGplus2: folds
Dealer: folds
Small Blind: folds
Big Blind: folds
Uncalled bet ($0.05) returned to UTGplus1
UTGplus1: doesn't show hand
UTGplus1 collected $0.12 from pot
*** SUMMARY ***
Total pot $0.12 | Rake $0.00
Seat 1: Hero showed
Seat 2: UTGplus1 won ($0.12)
Seat 3: UTGplus2 showed
Seat 4: Dealer (button) showed
Seat 5: Small Blind (small blind) showed
Seat 6: Big Blind (big blind) showed



PokerStars Zoom Hand #3434334497: Hold'em No Limit ($0.02/$0.05) - 2017/03/08 22:52:39
Table '#952' 6-max Seat #5 is the button
Seat 1: Big Blind ($5 in chips)
Seat 2: UTG ($3.52 in chips)
Seat 3: UTGplus1 ($3.63 in chips)
Seat 4: UTGplus2 ($4.37 in chips)
Seat 5: Hero ($12.53 in chips)
Seat 6: Small Blind ($14.04 in chips)
Small Blind: posts small blind $0.02
Big Blind: posts big blind $0.05
*** HOLE CARDS ***
Dealt to Hero [As 4h]
UTG: folds
UTGplus1: folds
UTGplus2: folds
Hero: raises $0.17 to $0.17
Small Blind: folds
Big Blind: folds
Uncalled bet ($0.12) returned to Hero
Hero: doesn't show hand
Hero collected $0.12 from pot
*** SUMMARY ***
Total pot $0.12 | Rake $0.00
Seat 1: Big Blind (big blind) showed
Seat 2: UTG showed
Seat 3: UTGplus1 showed
Seat 4: UTGplus2 showed
Seat 5: Hero (button) won ($0.12)
Seat 6: Small Blind (small blind) showed



PokerStars Zoom Hand #3434334676: Hold'em No Limit ($0.02/$0.05) - 2017/03/08 22:52:59
Table '#952' 6-max Seat #1 is the button
Seat 1: Dealer ($19.62 in chips)
Seat 2: Small Blind ($4.93 in chips)
Seat 3: Big Blind ($3.63 in chips)
Seat 4: UTG ($3.63 in chips)
Seat 5: UTGplus1 ($7.47 in chips)
Seat 6: Hero ($12.60 in chips)
Small Blind: posts small blind $0.02
Big Blind: posts big blind $0.05
*** HOLE CARDS ***
Dealt to Hero [9c 3s]
UTG: folds
UTGplus1: folds
Hero: folds
Dealer: raises $0.17 to $0.17
Small Blind: folds
Big Blind: calls $0.12 
*** FLOP *** [Td 9s 6h]
Big Blind: checks
Dealer: bets $0.25 
Big Blind: calls $0.25 
*** TURN *** [Td 9s 6h] [Ts]
Big Blind: checks
Dealer: bets $0.55 
Big Blind: calls $0.55 
*** RIVER *** [Td 9s 6h Ts] [6c]
Big Blind: checks
Dealer: bets $1.45 
Big Blind: calls $1.45 
*** SHOW DOWN ***
Dealer: shows [Tc 7h] (a full house, Tens full of Sixs)
Big Blind: shows [Jc Ks] (two pair, Tens and Kings)
Dealer collected $4.62 from pot
*** SUMMARY ***
Total pot $4.86 | Rake $0.24
Board [Td 9s 6h Ts 6c]
Seat 1: Dealer (button) showed [Tc 7h] and won ($4.62) with a full house, Tens full of Kings
Seat 2: Small Blind (small blind) showed
Seat 3: Big Blind (big blind) showed [Jc Ks] and lost with two pair, Tens and Kings
Seat 4: UTG showed
Seat 5: UTGplus1 showed
Seat 6: Hero showed



PokerStars Zoom Hand #3434334756: Hold'em No Limit ($0.02/$0.05) - 2017/03/08 22:53:08
Table '#952' 6-max Seat #4 is the button
Seat 1: UTG ($4.13 in chips)
Seat 2: UTGplus1 ($5 in chips)
Seat 3: UTGplus2 ($8.16 in chips)
Seat 4: Dealer ($8.69 in chips)
Seat 5: Small Blind ($4.20 in chips)
Seat 6: Hero ($12.60 in chips)
Small Blind: posts small blind $0.02
Hero: posts big blind $0.05
*** HOLE CARDS ***
Dealt to Hero [2c Jc]
UTG: folds
UTGplus1: folds
UTGplus2: folds
Dealer: folds
Small Blind: folds
*** SHOW DOWN ***
Hero: shows [2c Jc] (high card Deuce)
Hero collected $0.07 from pot
*** SUMMARY ***
Total pot $0.07 | Rake $0.00
Seat 1: UTG showed
Seat 2: UTGplus1 showed
Seat 3: UTGplus2 showed
Seat 4: Dealer (button) showed
Seat 5: Small Blind (small blind) showed
Seat 6: Hero (big blind) collected $0.02



PokerStars Zoom Hand #3434334803: Hold'em No Limit ($0.02/$0.05) - 2017/03/08 22:53:14
Table '#952' 6-max Seat #2 is the button
Seat 1: Hero ($12.55 in chips)
Seat 2: Dealer ($14.31 in chips)
Seat 3: Small Blind ($2.36 in chips)
Seat 4: Big Blind ($5.43 in chips)
Seat 5: UTG ($5.19 in chips)
Seat 6: UTGplus1 ($5 in chips)
Small Blind: posts small blind $0.02
Big Blind: posts big blind $0.05
*** HOLE CARDS ***
Dealt to Hero [7s 5d]
UTG: folds 
UTGplus1: calls $0.05 
Hero: folds
Dealer: raises $0.25 to $0.25
Small Blind: folds
UTG: Seat re-join
Big Blind: folds 
UTGplus1: calls $0.20 
*** FLOP *** [8h 5s Js]
UTGplus1: checks
Dealer: bets $0.35 
UTGplus1: folds
*** SHOW DOWN ***
Dealer: shows [5c 5h] (three of a kind, Fives)
Uncalled bet ($0.35) returned to Dealer
Dealer collected $0.55 from pot
*** SUMMARY ***
Total pot $0.57 | Rake $0.02
Board [8h 5s Js]
Seat 1: Hero showed
Seat 2: Dealer (button) showed [5c 5h] and won ($0.55) with three of a kind, Fives
Seat 3: Small Blind (small blind) showed
Seat 4: Big Blind (big blind) showed
Seat 5: UTG showed
Seat 6: UTGplus1 showed



PokerStars Zoom Hand #3434334831: Hold'em No Limit ($0.02/$0.05) - 2017/03/08 22:53:19
Table '#952' 6-max Seat #5 is the button
Seat 1: Big Blind ($14.07 in chips)
Seat 2: UTG ($8.16 in chips)
Seat 3: UTGplus1 ($3 in chips)
Seat 4: UTGplus2 ($3.71 in chips)
Seat 5: Hero ($12.62 in chips)
Seat 6: Small Blind ($3.71 in chips)
Small Blind: posts small blind $0.02
Big Blind: posts big blind $0.05
*** HOLE CARDS ***
Dealt to Hero [3c 3s]
UTG: folds
UTGplus1: folds
UTGplus2: folds
Hero: raises $0.17 to $0.17
Small Blind: folds
Big Blind: folds
Uncalled bet ($0.12) returned to Hero
Hero: doesn't show hand
Hero collected $0.12 from pot
Seat re-join
*** SUMMARY ***
Total pot $0.12 | Rake $0.00
Seat 1: Big Blind (big blind) showed
Seat 2: UTG showed
Seat 3: UTGplus1 showed
Seat 4: UTGplus2 showed
Seat 5: Hero (button) won ($0.12)
Seat 6: Small Blind (small blind) showed



PokerStars Zoom Hand #3434335028: Hold'em No Limit ($0.02/$0.05) - 2017/03/08 22:53:42
Table '#952' 6-max Seat #3 is the button
Seat 1: Hero ($12.69 in chips)
Seat 2: UTGplus2 ($21.53 in chips)
Seat 3: Dealer ($4.98 in chips)
Seat 4: Small Blind ($9.99 in chips)
Seat 5: Big Blind ($5.07 in chips)
Seat 6: UTG ($3.66 in chips)
Small Blind: posts small blind $0.02
Big Blind: posts big blind $0.05
*** HOLE CARDS ***
Dealt to Hero [Td 5s]
UTG: folds
Hero: folds
UTGplus2: folds
Dealer: raises $0.15 to $0.15
Small Blind: calls $0.13 
Big Blind: folds
*** FLOP *** [8s Ah 8c]
Small Blind: checks
Dealer: bets $0.15 
Small Blind: calls $0.15 
*** TURN *** [8s Ah 8c] [Kh]
Small Blind: checks
Dealer: bets $0.30 
Small Blind: folds
Uncalled bet ($0.30) returned to Dealer
Dealer: doesn't show hand
Dealer collected $0.62 from pot
Table deposit $2.50 
Seat re-join
*** SUMMARY ***
Total pot $0.65 | Rake $0.03
Board [8s Ah 8c Kh]
Seat 1: Hero showed
Seat 2: UTGplus2 showed
Seat 3: Dealer (button) won ($0.62)
Seat 4: Small Blind (small blind) showed
Seat 5: Big Blind (big blind) showed
Seat 6: UTG showed



PokerStars Zoom Hand #3434335075: Hold'em No Limit ($0.02/$0.05) - 2017/03/08 22:53:48
Table '#952' 6-max Seat #3 is the button
Seat 1: UTGplus1 ($2.28 in chips)
Seat 2: Hero ($12.69 in chips)
Seat 3: Dealer ($0.90 in chips)
Seat 4: Small Blind ($16.13 in chips)
Seat 5: Big Blind ($4.19 in chips)
Seat 6: UTG ($3.66 in chips)
Small Blind: posts small blind $0.02
Big Blind: posts big blind $0.05
*** HOLE CARDS ***
Dealt to Hero [Tc Ts]
UTG: raises $0.15 to $0.15
UTGplus1: calls $0.15 
Hero: raises $0.67 to $0.67
Dealer: raises $0.23 to $0.90 and is all-in
Small Blind: folds
Big Blind: folds
UTG: raises $1.72 to $1.87
UTGplus1: folds
Hero: calls $1.20 
*** FLOP *** [2s 3h 9h]
UTG: bets $1.79 and is all-in
Hero: calls $1.79 
*** TURN *** [2s 3h 9h] [Js]
*** RIVER *** [2s 3h 9h Js] [7c]
*** SHOW DOWN ***
Hero: shows [Tc Ts] (a pair of Tens)
Dealer: shows [Qh Qc] (a pair of Queens)
UTG: shows [Ks Kc] (a pair of Kings)
UTG collected $5.25 from side pot
UTG collected $2.77 from main pot
*** SUMMARY ***
Total pot $8.44 | Rake $0.42
Board [2s 3h 9h Js 7c]
Seat 1: UTGplus1 showed
Seat 2: Hero showed [Tc Ts] and lost with a pair of Tens
Seat 3: Dealer (button) showed [Qh Qc] and lost with a pair of Queens
Seat 4: Small Blind (small blind) showed
Seat 5: Big Blind (big blind) showed
Seat 6: UTG showed [Ks Kc] and won ($8.02) with a pair of Kings



PokerStars Zoom Hand #3434335548: Hold'em No Limit ($0.02/$0.05) - 2017/03/08 22:54:46
Table '#952' 6-max Seat #5 is the button
Seat 1: Big Blind ($2.50 in chips)
Seat 2: UTG ($14.56 in chips)
Seat 3: Hero ($9.03 in chips)
Seat 4: UTGplus2 ($8.02 in chips)
Seat 5: Dealer ($12.18 in chips)
Seat 6: Small Blind ($2 in chips)
Small Blind: posts small blind $0.02
Big Blind: posts big blind $0.05
*** HOLE CARDS ***
Dealt to Hero [3d 4d]
UTG: folds
Hero: folds
UTGplus2: raises $0.15 to $0.15
Dealer: folds
Small Blind: folds
Big Blind: calls $0.10 
*** FLOP *** [9s Ah 6s]
Big Blind: bets $0.05 
UTGplus2: raises $0.23 to $0.23
Big Blind: calls $0.18 
*** TURN *** [9s Ah 6s] [Tc]
Big Blind: bets $0.12 
UTGplus2: calls $0.12 
*** RIVER *** [9s Ah 6s Tc] [9c]
Big Blind: bets $0.14 
UTGplus2: calls $0.14 
*** SHOW DOWN ***
Big Blind: shows [Ts Js] (two pair, Tens and Aces)
UTGplus2: shows [3s As] (two pair, Aces and Tens)
UTGplus2 collected $1.24 from pot
*** SUMMARY ***
Total pot $1.3 | Rake $0.06
Board [9s Ah 6s Tc 9c]
Seat 1: Big Blind (big blind) showed [Ts Js] and lost with two pair, Tens and Aces
Seat 2: UTG showed
Seat 3: Hero showed
Seat 4: UTGplus2 showed [3s As] and won ($1.24) with two pair, Aces and Tens
Seat 5: Dealer (button) showed
Seat 6: Small Blind (small blind) showed



PokerStars Zoom Hand #3434335614: Hold'em No Limit ($0.02/$0.05) - 2017/03/08 22:54:54
Table '#952' 6-max Seat #3 is the button
Seat 1: UTGplus1 ($2.50 in chips)
Seat 2: UTGplus2 ($21.84 in chips)
Seat 3: Hero ($9.03 in chips)
Seat 4: Small Blind ($3.57 in chips)
Seat 5: Big Blind ($1.98 in chips)
Seat 6: UTG ($8.42 in chips)
Small Blind: posts small blind $0.02
Big Blind: posts big blind $0.05
*** HOLE CARDS ***
Dealt to Hero [Qd Jh]
UTG: folds
UTGplus1: folds
UTGplus2: folds
Hero: raises $0.17 to $0.17
Small Blind: folds
Big Blind: folds
Uncalled bet ($0.12) returned to Hero
Hero: doesn't show hand
Hero collected $0.12 from pot
*** SUMMARY ***
Total pot $0.12 | Rake $0.00
Seat 1: UTGplus1 showed
Seat 2: UTGplus2 showed
Seat 3: Hero (button) won ($0.12)
Seat 4: Small Blind (small blind) showed
Seat 5: Big Blind (big blind) showed
Seat 6: UTG showed



PokerStars Zoom Hand #3434335798: Hold'em No Limit ($0.02/$0.05) - 2017/03/08 22:55:16
Table '#952' 6-max Seat #3 is the button
Seat 1: UTGplus1 ($3.55 in chips)
Seat 2: UTGplus2 ($12.11 in chips)
Seat 3: Dealer ($8.70 in chips)
Seat 4: Hero ($9.10 in chips)
Seat 5: Big Blind ($8.38 in chips)
Seat 6: UTG ($9.03 in chips)
Hero: posts small blind $0.02
Big Blind: posts big blind $0.05
*** HOLE CARDS ***
Dealt to Hero [Jc Th]
UTG: folds
UTGplus1: folds
UTGplus2: folds
Dealer: folds
Hero: raises $0.13 to $0.15
Big Blind: folds
Uncalled bet ($0.10) returned to Hero
Hero: doesn't show hand
Hero collected $0.1 from pot
*** SUMMARY ***
Total pot $0.1 | Rake $0.00
Seat 1: UTGplus1 showed
Seat 2: UTGplus2 showed
Seat 3: Dealer (button) showed
Seat 4: Hero (small blind) won ($0.1)
Seat 5: Big Blind (big blind) showed
Seat 6: UTG showed



PokerStars Zoom Hand #3434336034: Hold'em No Limit ($0.02/$0.05) - 2017/03/08 22:55:44
Table '#952' 6-max Seat #1 is the button
Seat 1: Dealer ($2.77 in chips)
Seat 2: Small Blind ($4.51 in chips)
Seat 3: Hero ($9.15 in chips)
Seat 4: UTG ($7.83 in chips)
Seat 5: UTGplus1 ($13.38 in chips)
Seat 6: UTGplus2 ($8.24 in chips)
Small Blind: posts small blind $0.02
Hero: posts big blind $0.05
*** HOLE CARDS ***
Dealt to Hero [5c 9d]
UTG: folds
UTGplus1: folds
UTGplus2: folds
Dealer: raises $0.15 to $0.15
Small Blind: folds
Hero: folds
Uncalled bet ($0.10) returned to Dealer
Dealer: doesn't show hand
Dealer collected $0.12 from pot
*** SUMMARY ***
Total pot $0.12 | Rake $0.00
Seat 1: Dealer (button) won ($0.12)
Seat 2: Small Blind (small blind) showed
Seat 3: Hero (big blind) showed
Seat 4: UTG showed
Seat 5: UTGplus1 showed
Seat 6: UTGplus2 showed



PokerStars Zoom Hand #3434336129: Hold'em No Limit ($0.02/$0.05) - 2017/03/08 22:55:56
Table '#952' 6-max Seat #3 is the button
Seat 1: UTGplus1 ($14.77 in chips)
Seat 2: Hero ($9.10 in chips)
Seat 3: Dealer ($6.05 in chips)
Seat 4: Small Blind ($6.63 in chips)
Seat 5: Big Blind ($5.42 in chips)
Seat 6: UTG ($3.86 in chips)
Small Blind: posts small blind $0.02
Big Blind: posts big blind $0.05
*** HOLE CARDS ***
Dealt to Hero [7h Qs]
UTG: folds
UTGplus1: folds
Hero: folds
Dealer: raises $0.15 to $0.15
Small Blind: folds
Big Blind: folds
Uncalled bet ($0.10) returned to Dealer
Dealer: doesn't show hand
Dealer collected $0.12 from pot
*** SUMMARY ***
Total pot $0.12 | Rake $0.00
Seat 1: UTGplus1 showed
Seat 2: Hero showed
Seat 3: Dealer (button) won ($0.12)
Seat 4: Small Blind (small blind) showed
Seat 5: Big Blind (big blind) showed
Seat 6: UTG showed



PokerStars Zoom Hand #3434336186: Hold'em No Limit ($0.02/$0.05) - 2017/03/08 22:56:04
Table '#952' 6-max Seat #6 is the button
Seat 1: Small Blind ($2.54 in chips)
Seat 2: Big Blind ($2.84 in chips)
Seat 3: UTG ($25.87 in chips)
Seat 4: Hero ($9.10 in chips)
Seat 5: UTGplus2 ($8.03 in chips)
Seat 6: Dealer ($14.72 in chips)
Small Blind: posts small blind $0.02
Big Blind: posts big blind $0.05
*** HOLE CARDS ***
Dealt to Hero [2h 6h]
UTG: raises $0.17 to $0.17
Hero: folds
UTGplus2: folds
Dealer: folds
Small Blind: folds
Big Blind: folds
Uncalled bet ($0.12) returned to UTG
UTG: doesn't show hand
UTG collected $0.12 from pot
*** SUMMARY ***
Total pot $0.12 | Rake $0.00
Seat 1: Small Blind (small blind) showed
Seat 2: Big Blind (big blind) showed
Seat 3: UTG won ($0.12)
Seat 4: Hero showed
Seat 5: UTGplus2 showed
Seat 6: Dealer (button) showed



PokerStars Zoom Hand #3434336266: Hold'em No Limit ($0.02/$0.05) - 2017/03/08 22:56:13
Table '#952' 6-max Seat #6 is the button
Seat 1: Hero ($9.10 in chips)
Seat 2: Big Blind ($8.60 in chips)
Seat 3: UTG ($5.64 in chips)
Seat 4: UTGplus1 ($14.72 in chips)
Seat 5: UTGplus2 ($3.94 in chips)
Seat 6: Dealer ($10.82 in chips)
Hero: posts small blind $0.02
Big Blind: posts big blind $0.05
*** HOLE CARDS ***
Dealt to Hero [8c 5s]
UTG: folds
UTGplus1: raises $0.25 to $0.25
UTGplus2: folds
Dealer: folds
Hero: folds
Big Blind: calls $0.20 
*** FLOP *** [3d Js Ah]
Big Blind: checks
UTGplus1: bets $0.35 
Big Blind: raises $1.57 to $1.57
UTGplus1: folds
Uncalled bet ($1.22) returned to Big Blind
Big Blind: doesn't show hand
Big Blind collected $1.16 from pot
*** SUMMARY ***
Total pot $1.22 | Rake $0.06
Board [3d Js Ah]
Seat 1: Hero (small blind) showed
Seat 2: Big Blind (big blind) won ($1.16)
Seat 3: UTG showed
Seat 4: UTGplus1 showed
Seat 5: UTGplus2 showed
Seat 6: Dealer (button) showed



PokerStars Zoom Hand #3434336329: Hold'em No Limit ($0.02/$0.05) - 2017/03/08 22:56:21
Table '#952' 6-max Seat #2 is the button
Seat 1: Hero ($9.08 in chips)
Seat 2: Dealer ($1.38 in chips)
Seat 3: Small Blind ($2.07 in chips)
Seat 4: Big Blind ($5.32 in chips)
Seat 5: UTG ($13.33 in chips)
Seat 6: UTGplus1 ($9.44 in chips)
Small Blind: posts small blind $0.02
Big Blind: posts big blind $0.05
*** HOLE CARDS ***
Dealt to Hero [Qc 6d]
UTG: folds
UTGplus1: folds
Hero: folds
Dealer: raises $0.10 to $0.10
Small Blind: folds
Big Blind: folds
Uncalled bet ($0.05) returned to Dealer
Dealer: doesn't show hand
Dealer collected $0.12 from pot
*** SUMMARY ***
Total pot $0.12 | Rake $0.00
Seat 1: Hero showed
Seat 2: Dealer (button) won ($0.12)
Seat 3: Small Blind (small blind) showed
Seat 4: Big Blind (big blind) showed
Seat 5: UTG showed
Seat 6: UTGplus1 showed



PokerStars Zoom Hand #3434336375: Hold'em No Limit ($0.02/$0.05) - 2017/03/08 22:56:26
Table '#952' 6-max Seat #6 is the button
Seat 1: Small Blind ($7.56 in chips)
Seat 2: Big Blind ($13.33 in chips)
Seat 3: UTG ($2.05 in chips)
Seat 4: Hero ($9.08 in chips)
Seat 5: UTGplus2 ($8.21 in chips)
Seat 6: Dealer ($5.64 in chips)
Small Blind: posts small blind $0.02
Big Blind: posts big blind $0.05
*** HOLE CARDS ***
Dealt to Hero [Jh 7h]
UTG: raises $0.10 to $0.10
Hero: folds
UTGplus2: folds
Dealer: folds
Small Blind: folds
Big Blind: calls $0.05 
*** FLOP *** [9h 4d 3h]
Big Blind: checks
UTG: bets $0.05 
Big Blind: folds
Uncalled bet ($0.05) returned to UTG
UTG: doesn't show hand
UTG collected $0.21 from pot
*** SUMMARY ***
Total pot $0.22 | Rake $0.01
Board [9h 4d 3h]
Seat 1: Small Blind (small blind) showed
Seat 2: Big Blind (big blind) showed
Seat 3: UTG won ($0.21)
Seat 4: Hero showed
Seat 5: UTGplus2 showed
Seat 6: Dealer (button) showed



PokerStars Zoom Hand #3434336427: Hold'em No Limit ($0.02/$0.05) - 2017/03/08 22:56:33
Table '#952' 6-max Seat #2 is the button
Seat 1: UTGplus2 ($16.29 in chips)
Seat 2: Dealer ($8.62 in chips)
Seat 3: Small Blind ($3.31 in chips)
Seat 4: Big Blind ($2.50 in chips)
Seat 5: UTG ($25.94 in chips)
Seat 6: Hero ($9.08 in chips)
Small Blind: posts small blind $0.02
Big Blind: posts big blind $0.05
*** HOLE CARDS ***
Dealt to Hero [Ac 9h]
UTG: folds
Hero: folds
UTGplus2: calls $0.05 
Dealer: folds
Small Blind: raises $3.26 to $3.31 and is all-in
Big Blind: folds
UTGplus2: folds
Uncalled bet ($3.26) returned to Small Blind
Small Blind: doesn't show hand
Small Blind collected $0.15 from pot
*** SUMMARY ***
Total pot $0.15 | Rake $0.00
Seat 1: UTGplus2 showed
Seat 2: Dealer (button) showed
Seat 3: Small Blind (small blind) won ($0.15)
Seat 4: Big Blind (big blind) showed
Seat 5: UTG showed
Seat 6: Hero showed



PokerStars Zoom Hand #3434336481: Hold'em No Limit ($0.02/$0.05) - 2017/03/08 22:56:40
Table '#952' 6-max Seat #5 is the button
Seat 1: Big Blind ($6.10 in chips)
Seat 2: UTG ($2.13 in chips)
Seat 3: Hero ($9.08 in chips)
Seat 4: UTGplus2 ($21.64 in chips)
Seat 5: Dealer ($2.50 in chips)
Seat 6: Small Blind ($2.65 in chips)
Small Blind: posts small blind $0.02
Big Blind: posts big blind $0.05
*** HOLE CARDS ***
Dealt to Hero [5d Th]
UTG: calls $0.05 
Hero: folds
UTGplus2: folds
Dealer: calls $0.05 
Small Blind: folds
Big Blind: checks
*** FLOP *** [3h Tc 7s]
Big Blind: checks
UTG: checks
Dealer: checks
*** TURN *** [3h Tc 7s] [Td]
Big Blind: bets $0.10 
UTG: folds
Dealer: calls $0.10 
*** RIVER *** [3h Tc 7s Td] [7c]
Big Blind: checks
Dealer: checks
*** SHOW DOWN ***
Big Blind: shows [Ts 4d] (a full house, Tens full of Sevens)
Dealer: shows [9c 9s] (Two pair)
Big Blind collected $0.36 from pot
*** SUMMARY ***
Total pot $0.37 | Rake $0.01
Board [3h Tc 7s Td 7c]
Seat 1: Big Blind (big blind) showed [Ts 4d] and won ($0.36) with a full house, Tens full of Sevens
Seat 2: UTG showed
Seat 3: Hero showed
Seat 4: UTGplus2 showed
Seat 5: Dealer (button) showed [9c 9s]
Seat 6: Small Blind (small blind) showed



PokerStars Zoom Hand #3434336523: Hold'em No Limit ($0.02/$0.05) - 2017/03/08 22:56:46
Table '#952' 6-max Seat #2 is the button
Seat 1: UTGplus2 ($3.89 in chips)
Seat 2: Dealer ($4.64 in chips)
Seat 3: Small Blind ($11.26 in chips)
Seat 4: Hero ($9.08 in chips)
Seat 5: UTG ($5.22 in chips)
Seat 6: UTGplus1 ($12.58 in chips)
Small Blind: posts small blind $0.02
Hero: posts big blind $0.05
*** HOLE CARDS ***
Dealt to Hero [Qs 5d]
UTG: calls $0.05 
UTGplus1: folds
UTGplus2: folds
Dealer: folds
Small Blind: raises $0.18 to $0.20
Hero: folds
UTG: calls $0.15 
*** FLOP *** [2h 5c As]
Small Blind: bets $0.20 
UTG: calls $0.20 
*** TURN *** [2h 5c As] [7h]
Small Blind: checks
UTG: checks
*** RIVER *** [2h 5c As 7h] [4h]
Small Blind: bets $0.25 
UTG: raises $1 to $1
Small Blind: folds
Uncalled bet ($0.75) returned to UTG
UTG: doesn't show hand
UTG collected $1.29 from pot
*** SUMMARY ***
Total pot $1.35 | Rake $0.06
Board [2h 5c As 7h 4h]
Seat 1: UTGplus2 showed
Seat 2: Dealer (button) showed
Seat 3: Small Blind (small blind) showed
Seat 4: Hero (big blind) showed
Seat 5: UTG won ($1.29)
Seat 6: UTGplus1 showed



PokerStars Zoom Hand #3434336555: Hold'em No Limit ($0.02/$0.05) - 2017/03/08 22:56:51
Table '#952' 6-max Seat #2 is the button
Seat 1: UTGplus2 ($9.16 in chips)
Seat 2: Hero ($9.03 in chips)
Seat 3: Small Blind ($2.50 in chips)
Seat 4: Big Blind ($3.89 in chips)
Seat 5: UTG ($4.27 in chips)
Seat 6: UTGplus1 ($2.45 in chips)
Small Blind: posts small blind $0.02
Big Blind: posts big blind $0.05
*** HOLE CARDS ***
Dealt to Hero [8s 2s]
UTG: folds
UTGplus1: folds
UTGplus2: folds
Hero: folds
Small Blind: raises $0.27 to $0.29
Big Blind: folds
Uncalled bet ($0.24) returned to Small Blind
Small Blind: doesn't show hand
Small Blind collected $0.1 from pot
*** SUMMARY ***
Total pot $0.1 | Rake $0.00
Seat 1: UTGplus2 showed
Seat 2: Hero (button) showed
Seat 3: Small Blind (small blind) won ($0.1)
Seat 4: Big Blind (big blind) showed
Seat 5: UTG showed
Seat 6: UTGplus1 showed



PokerStars Zoom Hand #3434336636: Hold'em No Limit ($0.02/$0.05) - 2017/03/08 22:57:00
Table '#952' 6-max Seat #4 is the button
Seat 1: UTG ($5.63 in chips)
Seat 2: UTGplus1 ($6.16 in chips)
Seat 3: UTGplus2 ($21.57 in chips)
Seat 4: Hero ($9.03 in chips)
Seat 5: Small Blind ($3.30 in chips)
Seat 6: Big Blind ($3.54 in chips)
Small Blind: posts small blind $0.02
Big Blind: posts big blind $0.05
*** HOLE CARDS ***
Dealt to Hero [2d Ad]
UTG: folds
UTGplus1: folds
UTGplus2: folds
Hero: raises $0.17 to $0.17
Small Blind: folds
Big Blind: folds
Uncalled bet ($0.12) returned to Hero
Hero: doesn't show hand
Hero collected $0.12 from pot
*** SUMMARY ***
Total pot $0.12 | Rake $0.00
Seat 1: UTG showed
Seat 2: UTGplus1 showed
Seat 3: UTGplus2 showed
Seat 4: Hero (button) won ($0.12)
Seat 5: Small Blind (small blind) showed
Seat 6: Big Blind (big blind) showed



PokerStars Zoom Hand #3434336885: Hold'em No Limit ($0.02/$0.05) - 2017/03/08 22:57:30
Table '#952' 6-max Seat #2 is the button
Seat 1: Hero ($9.10 in chips)
Seat 2: Dealer ($9.19 in chips)
Seat 3: Small Blind ($10.56 in chips)
Seat 4: Big Blind ($4.12 in chips)
Seat 5: UTG ($2.11 in chips)
Seat 6: UTGplus1 ($3.06 in chips)
Small Blind: posts small blind $0.02
Big Blind: posts big blind $0.05
*** HOLE CARDS ***
Dealt to Hero [7d As]
UTG: folds
UTGplus1: folds
Hero: folds
Dealer: folds
Small Blind: calls $0.03 
Big Blind: checks
*** FLOP *** [Ac 3h 5c]
Small Blind: bets $0.05 
Big Blind: folds
Uncalled bet ($0.05) returned to Small Blind
Small Blind: doesn't show hand
Small Blind collected $0.1 from pot
*** SUMMARY ***
Total pot $0.1 | Rake $0.00
Board [Ac 3h 5c]
Seat 1: Hero showed
Seat 2: Dealer (button) showed
Seat 3: Small Blind (small blind) won ($0.1)
Seat 4: Big Blind (big blind) showed
Seat 5: UTG showed
Seat 6: UTGplus1 showed



PokerStars Zoom Hand #3434336926: Hold'em No Limit ($0.02/$0.05) - 2017/03/08 22:57:36
Table '#952' 6-max Seat #2 is the button
Seat 1: UTGplus2 ($3.09 in chips)
Seat 2: Hero ($9.10 in chips)
Seat 3: Small Blind ($4.07 in chips)
Seat 4: Big Blind ($3.71 in chips)
Seat 5: UTG ($3.84 in chips)
Seat 6: UTGplus1 ($8.01 in chips)
Small Blind: posts small blind $0.02
Big Blind: posts big blind $0.05
*** HOLE CARDS ***
Dealt to Hero [5d Ac]
UTG: raises $0.15 to $0.15
UTGplus1: calls $0.15 
UTGplus2: calls $0.15 
Hero: folds
Small Blind: folds
Big Blind: folds
*** FLOP *** [9c 3d 9d]
UTG: checks
UTGplus1: checks
UTGplus2: checks
*** TURN *** [9c 3d 9d] [Qc]
UTG: checks
UTGplus1: checks
UTGplus2: checks
*** RIVER *** [9c 3d 9d Qc] [Ts]
UTG: checks
UTGplus1: checks
UTGplus2: checks
*** SHOW DOWN ***
UTG: shows [Ad Kh] (a pair of Nines)
UTGplus1: shows [2h 5h] (a pair of Nines)
UTGplus2: shows [8h 7d] (a pair of Nines)
UTG collected $0.5 from pot
*** SUMMARY ***
Total pot $0.52 | Rake $0.02
Board [9c 3d 9d Qc Ts]
Seat 1: UTGplus2 showed [8h 7d] and lost with a pair of Nines
Seat 2: Hero (button) showed
Seat 3: Small Blind (small blind) showed
Seat 4: Big Blind (big blind) showed
Seat 5: UTG showed [Ad Kh] and won ($0.5) with a pair of Nines
Seat 6: UTGplus1 showed [2h 5h] and lost with a pair of Nines



PokerStars Zoom Hand #3434337013: Hold'em No Limit ($0.02/$0.05) - 2017/03/08 22:57:46
Table '#952' 6-max Seat #4 is the button
Seat 1: Hero ($9.10 in chips)
Seat 2: UTGplus1 ($1.32 in chips)
Seat 3: UTGplus2 ($3.51 in chips)
Seat 4: Dealer ($5.75 in chips)
Seat 5: Small Blind ($3.36 in chips)
Seat 6: Big Blind ($5.32 in chips)
Small Blind: posts small blind $0.02
Big Blind: posts big blind $0.05
*** HOLE CARDS ***
Dealt to Hero [Ad Kd]
Hero: raises $0.17 to $0.17
UTGplus1: folds
UTGplus2: folds
Dealer: calls $0.17 
Small Blind: folds
Big Blind: folds
*** FLOP *** [Ac 3s 8s]
Hero: checks
Dealer: checks
*** TURN *** [Ac 3s 8s] [3h]
Hero: checks
Dealer: bets $0.18 
Hero: calls $0.18 
*** RIVER *** [Ac 3s 8s 3h] [8d]
Hero: checks
Dealer: checks
*** SHOW DOWN ***
Hero: shows [Ad Kd] (two pair, Aces and Kings)
Dealer: shows [Td Th] (Two pair)
Hero collected $0.74 from pot
*** SUMMARY ***
Total pot $0.77 | Rake $0.03
Board [Ac 3s 8s 3h 8d]
Seat 1: Hero showed [Ad Kd] and won ($0.74) with two pair, Aces and Kings
Seat 2: UTGplus1 showed
Seat 3: UTGplus2 showed
Seat 4: Dealer (button) showed [Td Th]
Seat 5: Small Blind (small blind) showed
Seat 6: Big Blind (big blind) showed



PokerStars Zoom Hand #3434337589: Hold'em No Limit ($0.02/$0.05) - 2017/03/08 22:58:54
Table '#952' 6-max Seat #6 is the button
Seat 1: Small Blind ($14.11 in chips)
Seat 2: Big Blind ($6.96 in chips)
Seat 3: UTG ($1.28 in chips)
Seat 4: UTGplus1 ($7.12 in chips)
Seat 5: Hero ($9.49 in chips)
Seat 6: Dealer ($5.40 in chips)
Small Blind: posts small blind $0.02
Big Blind: posts big blind $0.05
*** HOLE CARDS ***
Dealt to Hero [Th Ts]
UTG: folds
UTGplus1: folds
Hero: raises $0.17 to $0.17
Dealer: calls $0.17 
Small Blind: folds
Big Blind: folds
*** FLOP *** [9s 3d 8h]
Hero: bets $0.20 
Dealer: calls $0.20 
*** TURN *** [9s 3d 8h] [7d]
Hero: bets $0.55 
Dealer: raises $1.74 to $1.74
Hero: calls $1.19 
*** RIVER *** [9s 3d 8h 7d] [5h]
Hero: checks
Dealer: checks
*** SHOW DOWN ***
Hero: shows [Th Ts] (a pair of Tens)
Dealer: shows [8c 8d] (three of a kind, Eights)
Dealer collected $4.08 from pot
*** SUMMARY ***
Total pot $4.29 | Rake $0.21
Board [9s 3d 8h 7d 5h]
Seat 1: Small Blind (small blind) showed
Seat 2: Big Blind (big blind) showed
Seat 3: UTG showed
Seat 4: UTGplus1 showed
Seat 5: Hero showed [Th Ts] and lost with a pair of Tens
Seat 6: Dealer (button) showed [8c 8d] and won ($4.08) with three of a kind, Eights



PokerStars Zoom Hand #3434338296: Hold'em No Limit ($0.02/$0.05) - 2017/03/08 23:00:21
Table '#952' 6-max Seat #5 is the button
Seat 1: Hero ($7.38 in chips)
Seat 2: UTG ($7.37 in chips)
Seat 3: UTGplus1 ($1.91 in chips)
Seat 4: UTGplus2 ($3.96 in chips)
Seat 5: Dealer ($5.65 in chips)
Seat 6: Small Blind ($3.07 in chips)
Small Blind: posts small blind $0.02
Hero: posts big blind $0.05
*** HOLE CARDS ***
Dealt to Hero [2s 8s]
UTG: folds
UTGplus1: folds
UTGplus2: folds
Dealer: raises $0.15 to $0.15
Small Blind: folds
Hero: folds
Uncalled bet ($0.10) returned to Dealer
Dealer: doesn't show hand
Dealer collected $0.12 from pot
*** SUMMARY ***
Total pot $0.12 | Rake $0.00
Seat 1: Hero (big blind) showed
Seat 2: UTG showed
Seat 3: UTGplus1 showed
Seat 4: UTGplus2 showed
Seat 5: Dealer (button) won ($0.12)
Seat 6: Small Blind (small blind) showed



PokerStars Zoom Hand #3434338452: Hold'em No Limit ($0.02/$0.05) - 2017/03/08 23:00:39
Table '#952' 6-max Seat #5 is the button
Seat 1: Big Blind ($4.85 in chips)
Seat 2: UTG ($2.86 in chips)
Seat 3: Hero ($7.33 in chips)
Seat 4: UTGplus2 ($9.03 in chips)
Seat 5: Dealer ($4.90 in chips)
Seat 6: Small Blind ($3.05 in chips)
Small Blind: posts small blind $0.02
Big Blind: posts big blind $0.05
*** HOLE CARDS ***
Dealt to Hero [9d 5d]
UTG: raises $0.15 to $0.15
Hero: folds
UTGplus2: folds
Dealer: folds
Small Blind: raises $0.33 to $0.35
Big Blind: folds
UTG: calls $0.20 
*** FLOP *** [Qc 9c 5c]
Small Blind: checks
UTG: checks
*** TURN *** [Qc 9c 5c] [Ah]
Small Blind: bets $0.25 
UTG: folds
Uncalled bet ($0.25) returned to Small Blind
Small Blind: doesn't show hand
Small Blind collected $0.72 from pot
*** SUMMARY ***
Total pot $0.75 | Rake $0.03
Board [Qc 9c 5c Ah]
Seat 1: Big Blind (big blind) showed
Seat 2: UTG showed
Seat 3: Hero showed
Seat 4: UTGplus2 showed
Seat 5: Dealer (button) showed
Seat 6: Small Blind (small blind) won ($0.72)



PokerStars Zoom Hand #3434338509: Hold'em No Limit ($0.02/$0.05) - 2017/03/08 23:00:45
Table '#952' 6-max Seat #3 is the button
Seat 1: UTGplus1 ($3.51 in chips)
Seat 2: UTGplus2 ($2.38 in chips)
Seat 3: Dealer ($12.28 in chips)
Seat 4: Hero ($7.33 in chips)
Seat 5: Big Blind ($5.11 in chips)
Seat 6: UTG ($2.50 in chips)
Hero: posts small blind $0.02
Big Blind: posts big blind $0.05
*** HOLE CARDS ***
Dealt to Hero [4c Qh]
UTG: folds
UTGplus1: folds
UTGplus2: folds
Dealer: folds
Hero: folds
Big Blind: doesn't show hand
Big Blind collected $0.07 from pot
*** SUMMARY ***
Total pot $0.07 | Rake $0.00
Seat 1: UTGplus1 showed
Seat 2: UTGplus2 showed
Seat 3: Dealer (button) showed
Seat 4: Hero (small blind) showed
Seat 5: Big Blind (big blind) won ($0.07)
Seat 6: UTG showed



PokerStars Zoom Hand #3434338544: Hold'em No Limit ($0.02/$0.05) - 2017/03/08 23:00:49
Table '#952' 6-max Seat #3 is the button
Seat 1: UTGplus1 ($12.28 in chips)
Seat 2: UTGplus2 ($2.10 in chips)
Seat 3: Hero ($7.31 in chips)
Seat 4: Small Blind ($2.50 in chips)
Seat 5: Big Blind ($8.13 in chips)
Seat 6: UTG ($5.16 in chips)
Small Blind: posts small blind $0.02
Big Blind: posts big blind $0.05
*** HOLE CARDS ***
Dealt to Hero [Jc Ah]
UTG: folds
UTGplus1: folds
UTGplus2: folds
Hero: raises $0.17 to $0.17
Small Blind: calls $0.15 
Big Blind: folds
*** FLOP *** [2c 8d Td]
Small Blind: bets $0.05 
Hero: calls $0.05 
*** TURN *** [2c 8d Td] [Js]
Small Blind: bets $0.94 
Hero: raises $3.31 to $3.31
Small Blind: calls $1.34 and is all-in
*** RIVER *** [2c 8d Td Js] [3c]
*** SHOW DOWN ***
Hero: shows [Jc Ah] (a pair of Jacks)
Small Blind: shows [Qs Qc] (a pair of Queens)
Uncalled bet ($1.03) returned to Hero
Small Blind collected $4.8 from pot
*** SUMMARY ***
Total pot $5.05 | Rake $0.25
Board [2c 8d Td Js 3c]
Seat 1: UTGplus1 showed
Seat 2: UTGplus2 showed
Seat 3: Hero (button) showed [Jc Ah] and lost with a pair of Jacks
Seat 4: Small Blind (small blind) showed [Qs Qc] and won ($4.8) with a pair of Queens
Seat 5: Big Blind (big blind) showed
Seat 6: UTG showed



PokerStars Zoom Hand #3434338965: Hold'em No Limit ($0.02/$0.05) - 2017/03/08 23:01:41
Table '#952' 6-max Seat #6 is the button
Seat 1: Small Blind ($13.31 in chips)
Seat 2: Hero ($4.81 in chips)
Seat 3: UTG ($4.80 in chips)
Seat 4: UTGplus1 ($13.64 in chips)
Seat 5: UTGplus2 ($1.49 in chips)
Seat 6: Dealer ($14.54 in chips)
Small Blind: posts small blind $0.02
Hero: posts big blind $0.05
*** HOLE CARDS ***
Dealt to Hero [3d 4d]
UTG: folds
UTGplus1: raises $0.25 to $0.25
UTGplus2: calls $0.25 
Dealer: folds
Small Blind: folds
Hero: folds
*** FLOP *** [2h 4s 3s]
UTGplus1: bets $0.35 
UTGplus2: folds
Uncalled bet ($0.35) returned to UTGplus1
UTGplus1: doesn't show hand
UTGplus1 collected $0.55 from pot
*** SUMMARY ***
Total pot $0.57 | Rake $0.02
Board [2h 4s 3s]
Seat 1: Small Blind (small blind) showed
Seat 2: Hero (big blind) showed
Seat 3: UTG showed
Seat 4: UTGplus1 won ($0.55)
Seat 5: UTGplus2 showed
Seat 6: Dealer (button) showed



PokerStars Zoom Hand #3434339119: Hold'em No Limit ($0.02/$0.05) - 2017/03/08 23:02:00
Table '#952' 6-max Seat #1 is the button
Seat 1: Hero ($4.76 in chips)
Seat 2: Small Blind ($4.96 in chips)
Seat 3: Big Blind ($13.29 in chips)
Seat 4: UTG ($1.28 in chips)
Seat 5: UTGplus1 ($14.52 in chips)
Seat 6: UTGplus2 ($4.96 in chips)
Small Blind: posts small blind $0.02
Big Blind: posts big blind $0.05
*** HOLE CARDS ***
Dealt to Hero [Qh Qd]
UTG: folds
UTGplus1: folds
UTGplus2: raises $0.15 to $0.15
Hero: raises $0.52 to $0.52
Small Blind: folds
Big Blind: folds 
UTGplus2: folds
Uncalled bet ($0.37) returned to Hero
Hero: doesn't show hand
Hero collected $0.37 from pot
UTG: Table leave user
*** SUMMARY ***
Total pot $0.37 | Rake $0.00
Seat 1: Hero (button) won ($0.37)
Seat 2: Small Blind (small blind) showed
Seat 3: Big Blind (big blind) showed
Seat 4: UTG showed
Seat 5: UTGplus1 showed
Seat 6: UTGplus2 showed



PokerStars Zoom Hand #3434339443: Hold'em No Limit ($0.02/$0.05) - 2017/03/08 23:02:39
Table '#952' 6-max Seat #6 is the button
Seat 1: Small Blind ($10.55 in chips)
Seat 2: Big Blind ($7.25 in chips)
Seat 3: UTG ($2.37 in chips)
Seat 4: Hero ($4.98 in chips)
Seat 5: UTGplus2 ($4.23 in chips)
Seat 6: Dealer ($2.77 in chips)
Small Blind: posts small blind $0.02
Big Blind: posts big blind $0.05
*** HOLE CARDS ***
Dealt to Hero [Ah Js]
UTG: folds
Hero: raises $0.17 to $0.17
UTGplus2: folds
Dealer: folds
Small Blind: folds
Big Blind: folds
Uncalled bet ($0.12) returned to Hero
Hero: doesn't show hand
Hero collected $0.12 from pot
*** SUMMARY ***
Total pot $0.12 | Rake $0.00
Seat 1: Small Blind (small blind) showed
Seat 2: Big Blind (big blind) showed
Seat 3: UTG showed
Seat 4: Hero won ($0.12)
Seat 5: UTGplus2 showed
Seat 6: Dealer (button) showed



PokerStars Zoom Hand #3434339603: Hold'em No Limit ($0.02/$0.05) - 2017/03/08 23:02:58
Table '#952' 6-max Seat #4 is the button
Seat 1: UTG ($15.64 in chips)
Seat 2: UTGplus1 ($2.91 in chips)
Seat 3: UTGplus2 ($1.76 in chips)
Seat 4: Hero ($5.05 in chips)
Seat 5: Small Blind ($5.88 in chips)
Seat 6: Big Blind ($4.82 in chips)
Small Blind: posts small blind $0.02
Big Blind: posts big blind $0.05
*** HOLE CARDS ***
Dealt to Hero [Qc 7d]
UTG: folds
UTGplus1: folds
UTGplus2: folds
Hero: folds
Small Blind: folds
Big Blind: doesn't show hand
Big Blind collected $0.07 from pot
*** SUMMARY ***
Total pot $0.07 | Rake $0.00
Seat 1: UTG showed
Seat 2: UTGplus1 showed
Seat 3: UTGplus2 showed
Seat 4: Hero (button) showed
Seat 5: Small Blind (small blind) showed
Seat 6: Big Blind (big blind) won ($0.07)



PokerStars Zoom Hand #3434339657: Hold'em No Limit ($0.02/$0.05) - 2017/03/08 23:03:04
Table '#952' 6-max Seat #4 is the button
Seat 1: Hero ($5.05 in chips)
Seat 2: UTGplus1 ($12.14 in chips)
Seat 3: UTGplus2 ($1.38 in chips)
Seat 4: Dealer ($10.51 in chips)
Seat 5: Small Blind ($5.62 in chips)
Seat 6: Big Blind ($1.76 in chips)
Small Blind: posts small blind $0.02
Big Blind: posts big blind $0.05
*** HOLE CARDS ***
Dealt to Hero [Jd 5h]
Hero: folds
UTGplus1: raises $0.27 to $0.27
UTGplus2: folds
Dealer: folds
Small Blind: folds
Big Blind: folds
Uncalled bet ($0.22) returned to UTGplus1
UTGplus1: doesn't show hand
UTGplus1 collected $0.12 from pot
*** SUMMARY ***
Total pot $0.12 | Rake $0.00
Seat 1: Hero showed
Seat 2: UTGplus1 won ($0.12)
Seat 3: UTGplus2 showed
Seat 4: Dealer (button) showed
Seat 5: Small Blind (small blind) showed
Seat 6: Big Blind (big blind) showed



PokerStars Zoom Hand #3434339705: Hold'em No Limit ($0.02/$0.05) - 2017/03/08 23:03:09
Table '#952' 6-max Seat #2 is the button
Seat 1: UTGplus2 ($1.38 in chips)
Seat 2: Dealer ($9.70 in chips)
Seat 3: Small Blind ($5.18 in chips)
Seat 4: Hero ($5.05 in chips)
Seat 5: UTG ($15.41 in chips)
Seat 6: UTGplus1 ($1.54 in chips)
Small Blind: posts small blind $0.02
Hero: posts big blind $0.05
*** HOLE CARDS ***
Dealt to Hero [9h 3h]
UTG: raises $0.15 to $0.15
UTGplus1: folds
UTGplus2: folds
Dealer: folds
Small Blind: folds
Hero: folds
Uncalled bet ($0.10) returned to UTG
UTG: doesn't show hand
UTG collected $0.12 from pot
*** SUMMARY ***
Total pot $0.12 | Rake $0.00
Seat 1: UTGplus2 showed
Seat 2: Dealer (button) showed
Seat 3: Small Blind (small blind) showed
Seat 4: Hero (big blind) showed
Seat 5: UTG won ($0.12)
Seat 6: UTGplus1 showed



PokerStars Zoom Hand #3434339746: Hold'em No Limit ($0.02/$0.05) - 2017/03/08 23:03:14
Table '#952' 6-max Seat #2 is the button
Seat 1: Hero ($5 in chips)
Seat 2: Dealer ($4.84 in chips)
Seat 3: Small Blind ($7.42 in chips)
Seat 4: Big Blind ($1.41 in chips)
Seat 5: UTG ($7.60 in chips)
Seat 6: UTGplus1 ($5.60 in chips)
Small Blind: posts small blind $0.02
Big Blind: posts big blind $0.05
*** HOLE CARDS ***
Dealt to Hero [Jc Ad]
UTG: folds 
UTGplus1: folds
Hero: raises $0.17 to $0.17
Dealer: folds
Small Blind: folds
UTG: Seat re-join
Big Blind: folds
Uncalled bet ($0.12) returned to Hero
Hero: doesn't show hand
Hero collected $0.12 from pot
*** SUMMARY ***
Total pot $0.12 | Rake $0.00
Seat 1: Hero won ($0.12)
Seat 2: Dealer (button) showed
Seat 3: Small Blind (small blind) showed
Seat 4: Big Blind (big blind) showed
Seat 5: UTG showed
Seat 6: UTGplus1 showed



PokerStars Zoom Hand #3434340030: Hold'em No Limit ($0.02/$0.05) - 2017/03/08 23:03:49
Table '#952' 6-max Seat #5 is the button
Seat 1: Big Blind ($2.50 in chips)
Seat 2: UTG ($8.24 in chips)
Seat 3: UTGplus1 ($4.68 in chips)
Seat 4: Hero ($5.07 in chips)
Seat 5: Dealer ($3.87 in chips)
Seat 6: Small Blind ($4.80 in chips)
Small Blind: posts small blind $0.02
Big Blind: posts big blind $0.05
*** HOLE CARDS ***
Dealt to Hero [2c 7h]
UTG: folds
UTGplus1: folds 
Hero: folds
Dealer: folds
Small Blind: folds
Big Blind: doesn't show hand
Big Blind collected $0.07 from pot
*** SUMMARY ***
Total pot $0.07 | Rake $0.00
Seat 1: Big Blind (big blind) won ($0.07)
Seat 2: UTG showed
Seat 3: UTGplus1 showed
Seat 4: Hero showed
Seat 5: Dealer (button) showed
Seat 6: Small Blind (small blind) showed



PokerStars Zoom Hand #3434340080: Hold'em No Limit ($0.02/$0.05) - 2017/03/08 23:03:56
Table '#952' 6-max Seat #5 is the button
Seat 1: Big Blind ($6.13 in chips)
Seat 2: UTG ($2.33 in chips)
Seat 3: UTGplus1 ($9.70 in chips)
Seat 4: Hero ($5.07 in chips)
Seat 5: Dealer ($4.90 in chips)
Seat 6: Small Blind ($6.08 in chips)
Small Blind: posts small blind $0.02
Big Blind: posts big blind $0.05
*** HOLE CARDS ***
Dealt to Hero [9h 3c]
UTG: folds
UTGplus1: folds
Hero: folds
Dealer: raises $0.15 to $0.15
Small Blind: calls $0.13 
Big Blind: folds
*** FLOP *** [4s 9c Ac]
Small Blind: checks
Dealer: bets $0.35 
Small Blind: folds
Uncalled bet ($0.35) returned to Dealer
Dealer: doesn't show hand
Dealer collected $0.34 from pot
Table leave user
*** SUMMARY ***
Total pot $0.35 | Rake $0.01
Board [4s 9c Ac]
Seat 1: Big Blind (big blind) showed
Seat 2: UTG showed
Seat 3: UTGplus1 showed
Seat 4: Hero showed
Seat 5: Dealer (button) won ($0.34)
Seat 6: Small Blind (small blind) showed



PokerStars Zoom Hand #3434340125: Hold'em No Limit ($0.02/$0.05) - 2017/03/08 23:04:02
Table '#952' 6-max Seat #5 is the button
Seat 1: Big Blind ($2.99 in chips)
Seat 2: UTG ($7.20 in chips)
Seat 3: UTGplus1 ($3.54 in chips)
Seat 4: Hero ($5.07 in chips)
Seat 5: Dealer ($2.43 in chips)
Seat 6: Small Blind ($2.43 in chips)
Small Blind: posts small blind $0.02
Big Blind: posts big blind $0.05
*** HOLE CARDS ***
Dealt to Hero [Ts 5s]
UTG: folds
UTGplus1: folds
Hero: folds
Dealer: folds
Small Blind: calls $0.03 
Big Blind: checks
*** FLOP *** [Qh Jh 7h]
Small Blind: bets $0.10 
Big Blind: folds
Uncalled bet ($0.10) returned to Small Blind
Small Blind: doesn't show hand
Small Blind collected $0.1 from pot
Table deposit $5 
*** SUMMARY ***
Total pot $0.1 | Rake $0.00
Board [Qh Jh 7h]
Seat 1: Big Blind (big blind) showed
Seat 2: UTG showed
Seat 3: UTGplus1 showed
Seat 4: Hero showed
Seat 5: Dealer (button) showed
Seat 6: Small Blind (small blind) won ($0.1)



PokerStars Zoom Hand #3434340151: Hold'em No Limit ($0.02/$0.05) - 2017/03/08 23:04:06
Table '#952' 6-max Seat #5 is the button
Seat 1: Big Blind ($5.07 in chips)
Seat 2: UTG ($2.51 in chips)
Seat 3: UTGplus1 ($4.80 in chips)
Seat 4: UTGplus2 ($7.20 in chips)
Seat 5: Dealer ($6.57 in chips)
Seat 6: Hero ($5.07 in chips)
Hero: posts small blind $0.02
Big Blind: posts big blind $0.05
*** HOLE CARDS ***
Dealt to Hero [6d Td]
UTG: folds
UTGplus1: folds
UTGplus2: raises $0.15 to $0.15
Dealer: folds
Hero: folds
Big Blind: folds
Uncalled bet ($0.10) returned to UTGplus2
UTGplus2: doesn't show hand
UTGplus2 collected $0.12 from pot
*** SUMMARY ***
Total pot $0.12 | Rake $0.00
Seat 1: Big Blind (big blind) showed
Seat 2: UTG showed
Seat 3: UTGplus1 showed
Seat 4: UTGplus2 won ($0.12)
Seat 5: Dealer (button) showed
Seat 6: Hero (small blind) showed



PokerStars Zoom Hand #3434340203: Hold'em No Limit ($0.02/$0.05) - 2017/03/08 23:04:13
Table '#952' 6-max Seat #6 is the button
Seat 1: Small Blind ($4.80 in chips)
Seat 2: Hero ($5.05 in chips)
Seat 3: UTG ($5 in chips)
Seat 4: UTGplus1 ($5.53 in chips)
Seat 5: UTGplus2 ($15.66 in chips)
Seat 6: Dealer ($4.83 in chips)
Small Blind: posts small blind $0.02
Hero: posts big blind $0.05
*** HOLE CARDS ***
Dealt to Hero [Jd Ts]
UTG: folds
UTGplus1: folds
UTGplus2: folds
Dealer: folds
Small Blind: folds
Hero: doesn't show hand
Hero collected $0.07 from pot
Table deposit $2.50 
Seat re-join
Table deposit $5 
*** SUMMARY ***
Total pot $0.07 | Rake $0.00
Seat 1: Small Blind (small blind) showed
Seat 2: Hero (big blind) won ($0.07)
Seat 3: UTG showed
Seat 4: UTGplus1 showed
Seat 5: UTGplus2 showed
Seat 6: Dealer (button) showed



PokerStars Zoom Hand #3434340337: Hold'em No Limit ($0.02/$0.05) - 2017/03/08 23:04:29
Table '#952' 6-max Seat #3 is the button
Seat 1: UTGplus1 ($10.85 in chips)
Seat 2: UTGplus2 ($14.02 in chips)
Seat 3: Dealer ($12.33 in chips)
Seat 4: Hero ($5.07 in chips)
Seat 5: Big Blind ($10.76 in chips)
Seat 6: UTG ($5.08 in chips)
Hero: posts small blind $0.02
Big Blind: posts big blind $0.05
*** HOLE CARDS ***
Dealt to Hero [2s 3c]
UTG: calls $0.05 
UTGplus1: folds
UTGplus2: raises $0.15 to $0.15
Dealer: folds
Hero: folds
Big Blind: calls $0.10 
UTG: calls $0.10 
*** FLOP *** [3s 2h Qh]
Big Blind: checks
UTG: checks
UTGplus2: bets $0.15 
Big Blind: raises $0.45 to $0.45
UTG: folds
UTGplus2: folds
Uncalled bet ($0.30) returned to Big Blind
Big Blind: doesn't show hand
Big Blind collected $0.74 from pot
*** SUMMARY ***
Total pot $0.77 | Rake $0.03
Board [3s 2h Qh]
Seat 1: UTGplus1 showed
Seat 2: UTGplus2 showed
Seat 3: Dealer (button) showed
Seat 4: Hero (small blind) showed
Seat 5: Big Blind (big blind) won ($0.74)
Seat 6: UTG showed



PokerStars Zoom Hand #3434340396: Hold'em No Limit ($0.02/$0.05) - 2017/03/08 23:04:36
Table '#952' 6-max Seat #5 is the button
Seat 1: Big Blind ($4.12 in chips)
Seat 2: UTG ($3.50 in chips)
Seat 3: UTGplus1 ($1.65 in chips)
Seat 4: Hero ($5.05 in chips)
Seat 5: Dealer ($5.55 in chips)
Seat 6: Small Blind ($4.78 in chips)
Small Blind: posts small blind $0.02
Big Blind: posts big blind $0.05
*** HOLE CARDS ***
Dealt to Hero [4d Ts]
UTG: folds
UTGplus1: folds
Hero: folds
Dealer: folds
Small Blind: folds
Big Blind: doesn't show hand
Big Blind collected $0.07 from pot
*** SUMMARY ***
Total pot $0.07 | Rake $0.00
Seat 1: Big Blind (big blind) won ($0.07)
Seat 2: UTG showed
Seat 3: UTGplus1 showed
Seat 4: Hero showed
Seat 5: Dealer (button) showed
Seat 6: Small Blind (small blind) showed



PokerStars Zoom Hand #3434340481: Hold'em No Limit ($0.02/$0.05) - 2017/03/08 23:04:46
Table '#952' 6-max Seat #3 is the button
Seat 1: Hero ($5.05 in chips)
Seat 2: UTGplus2 ($1.14 in chips)
Seat 3: Dealer ($15.61 in chips)
Seat 4: Small Blind ($2.48 in chips)
Seat 5: Big Blind ($2.10 in chips)
Seat 6: UTG ($7.35 in chips)
Small Blind: posts small blind $0.02
Big Blind: posts big blind $0.05
*** HOLE CARDS ***
Dealt to Hero [6c 3h]
UTG: calls $0.05 
Hero: folds
UTGplus2: folds
Dealer: folds
Small Blind: calls $0.03 
Big Blind: checks
*** FLOP *** [Kc 5d 6d]
Small Blind: checks
Big Blind: checks
UTG: bets $0.05 
Small Blind: calls $0.05 
Big Blind: folds
*** TURN *** [Kc 5d 6d] [Tc]
Small Blind: checks
UTG: checks
*** RIVER *** [Kc 5d 6d Tc] [7d]
Small Blind: checks
UTG: checks
*** SHOW DOWN ***
Small Blind: shows [5h 2h] (a pair of Fives)
UTG: shows [8c Ah] (High Card)
Small Blind collected $0.24 from pot
*** SUMMARY ***
Total pot $0.25 | Rake $0.01
Board [Kc 5d 6d Tc 7d]
Seat 1: Hero showed
Seat 2: UTGplus2 showed
Seat 3: Dealer (button) showed
Seat 4: Small Blind (small blind) showed [5h 2h] and won ($0.24) with a pair of Fives
Seat 5: Big Blind (big blind) showed
Seat 6: UTG showed [8c Ah]



PokerStars Zoom Hand #3434340525: Hold'em No Limit ($0.02/$0.05) - 2017/03/08 23:04:51
Table '#952' 6-max Seat #2 is the button
Seat 1: UTGplus2 ($9.28 in chips)
Seat 2: Dealer ($2.40 in chips)
Seat 3: Small Blind ($5 in chips)
Seat 4: Hero ($5.05 in chips)
Seat 5: UTG ($4.14 in chips)
Seat 6: UTGplus1 ($7.12 in chips)
Small Blind: posts small blind $0.02
Hero: posts big blind $0.05
*** HOLE CARDS ***
Dealt to Hero [7d 3h]
UTG: folds
UTGplus1: folds
UTGplus2: folds
Dealer: raises $0.15 to $0.15
Small Blind: raises $0.43 to $0.45
Hero: folds
Dealer: folds
Uncalled bet ($0.30) returned to Small Blind
Small Blind: doesn't show hand
Small Blind collected $0.35 from pot
*** SUMMARY ***
Total pot $0.35 | Rake $0.00
Seat 1: UTGplus2 showed
Seat 2: Dealer (button) showed
Seat 3: Small Blind (small blind) won ($0.35)
Seat 4: Hero (big blind) showed
Seat 5: UTG showed
Seat 6: UTGplus1 showed



PokerStars Zoom Hand #3434340575: Hold'em No Limit ($0.02/$0.05) - 2017/03/08 23:04:57
Table '#952' 6-max Seat #5 is the button
Seat 1: Big Blind ($1.66 in chips)
Seat 2: Hero ($5 in chips)
Seat 3: UTGplus1 ($10.70 in chips)
Seat 4: UTGplus2 ($9.70 in chips)
Seat 5: Dealer ($1.21 in chips)
Seat 6: Small Blind ($5.48 in chips)
Small Blind: posts small blind $0.02
Big Blind: posts big blind $0.05
*** HOLE CARDS ***
Dealt to Hero [4c Ad]
Hero: folds
UTGplus1: folds
UTGplus2: folds
Dealer: folds
Small Blind: raises $0.13 to $0.15
Big Blind: calls $0.10 
*** FLOP *** [2d Kh 2s]
Small Blind: checks
Big Blind: checks
*** TURN *** [2d Kh 2s] [8d]
Small Blind: checks
Big Blind: bets $0.30 
Small Blind: folds
*** SHOW DOWN ***
Big Blind: shows [Jd 8h] (two pair, Eights and Kings)
Uncalled bet ($0.30) returned to Big Blind
Big Blind collected $0.29 from pot
Table leave user
*** SUMMARY ***
Total pot $0.3 | Rake $0.01
Board [2d Kh 2s 8d]
Seat 1: Big Blind (big blind) showed [Jd 8h] and won ($0.29) with two pair, Eights and Kings
Seat 2: Hero showed
Seat 3: UTGplus1 showed
Seat 4: UTGplus2 showed
Seat 5: Dealer (button) showed
Seat 6: Small Blind (small blind) showed



PokerStars Zoom Hand #3434340624: Hold'em No Limit ($0.02/$0.05) - 2017/03/08 23:05:04
Table '#952' 6-max Seat #1 is the button
Seat 1: Dealer ($2.54 in chips)
Seat 2: Small Blind ($2.94 in chips)
Seat 3: Big Blind ($16.42 in chips)
Seat 4: UTG ($4.84 in chips)
Seat 5: Hero ($5 in chips)
Seat 6: UTGplus2 ($2.38 in chips)
Small Blind: posts small blind $0.02
Big Blind: posts big blind $0.05
*** HOLE CARDS ***
Dealt to Hero [Qs 4d]
UTG: folds
Hero: folds
UTGplus2: folds
Dealer: folds
Small Blind: calls $0.03 
Big Blind: checks
*** FLOP *** [3d 5s 6s]
Small Blind: checks
Big Blind: bets $0.05 
Small Blind: folds
Uncalled bet ($0.05) returned to Big Blind
Big Blind: doesn't show hand
Big Blind collected $0.1 from pot
*** SUMMARY ***
Total pot $0.1 | Rake $0.00
Board [3d 5s 6s]
Seat 1: Dealer (button) showed
Seat 2: Small Blind (small blind) showed
Seat 3: Big Blind (big blind) won ($0.1)
Seat 4: UTG showed
Seat 5: Hero showed
Seat 6: UTGplus2 showed



PokerStars Zoom Hand #3434340658: Hold'em No Limit ($0.02/$0.05) - 2017/03/08 23:05:08
Table '#952' 6-max Seat #2 is the button
Seat 1: UTGplus2 ($4.84 in chips)
Seat 2: Dealer ($6.10 in chips)
Seat 3: Small Blind ($15.59 in chips)
Seat 4: Big Blind ($10.70 in chips)
Seat 5: UTG ($12.59 in chips)
Seat 6: Hero ($5 in chips)
Small Blind: posts small blind $0.02
Big Blind: posts big blind $0.05
*** HOLE CARDS ***
Dealt to Hero [5d Qd]
UTG: folds
Hero: folds
UTGplus2: folds
Dealer: folds
Small Blind: folds
Big Blind: doesn't show hand
Big Blind collected $0.07 from pot
*** SUMMARY ***
Total pot $0.07 | Rake $0.00
Seat 1: UTGplus2 showed
Seat 2: Dealer (button) showed
Seat 3: Small Blind (small blind) showed
Seat 4: Big Blind (big blind) won ($0.07)
Seat 5: UTG showed
Seat 6: Hero showed



PokerStars Zoom Hand #3434340692: Hold'em No Limit ($0.02/$0.05) - 2017/03/08 23:05:13
Table '#952' 6-max Seat #6 is the button
Seat 1: Small Blind ($6.50 in chips)
Seat 2: Big Blind ($6.10 in chips)
Seat 3: UTG ($7.40 in chips)
Seat 4: UTGplus1 ($7.53 in chips)
Seat 5: Hero ($5 in chips)
Seat 6: Dealer ($5.02 in chips)
Small Blind: posts small blind $0.02
Big Blind: posts big blind $0.05
*** HOLE CARDS ***
Dealt to Hero [Ad 7s]
UTG: raises $0.15 to $0.15
UTGplus1: folds
Hero: folds
Dealer: folds
Small Blind: folds
Big Blind: calls $0.10 
*** FLOP *** [3h Kd 8c]
Big Blind: checks
UTG: bets $0.16 
Big Blind: calls $0.16 
*** TURN *** [3h Kd 8c] [As]
Big Blind: checks
UTG: bets $0.32 
Big Blind: folds
Uncalled bet ($0.32) returned to UTG
UTG: doesn't show hand
UTG collected $0.61 from pot
*** SUMMARY ***
Total pot $0.64 | Rake $0.03
Board [3h Kd 8c As]
Seat 1: Small Blind (small blind) showed
Seat 2: Big Blind (big blind) showed
Seat 3: UTG won ($0.61)
Seat 4: UTGplus1 showed
Seat 5: Hero showed
Seat 6: Dealer (button) showed



PokerStars Zoom Hand #3434340731: Hold'em No Limit ($0.02/$0.05) - 2017/03/08 23:05:18
Table '#952' 6-max Seat #6 is the button
Seat 1: Small Blind ($12.35 in chips)
Seat 2: Big Blind ($11.59 in chips)
Seat 3: UTG ($6.48 in chips)
Seat 4: UTGplus1 ($13.72 in chips)
Seat 5: UTGplus2 ($5.39 in chips)
Seat 6: Hero ($5 in chips)
Small Blind: posts small blind $0.02
Big Blind: posts big blind $0.05
*** HOLE CARDS ***
Dealt to Hero [2s Ac]
UTG: raises $0.15 to $0.15
UTGplus1: folds
UTGplus2: folds
Hero: folds
Small Blind: folds
Big Blind: folds
Uncalled bet ($0.10) returned to UTG
UTG: doesn't show hand
UTG collected $0.12 from pot
*** SUMMARY ***
Total pot $0.12 | Rake $0.00
Seat 1: Small Blind (small blind) showed
Seat 2: Big Blind (big blind) showed
Seat 3: UTG won ($0.12)
Seat 4: UTGplus1 showed
Seat 5: UTGplus2 showed
Seat 6: Hero (button) showed



PokerStars Zoom Hand #3434340784: Hold'em No Limit ($0.02/$0.05) - 2017/03/08 23:05:24
Table '#952' 6-max Seat #6 is the button
Seat 1: Small Blind ($4.58 in chips)
Seat 2: Hero ($5 in chips)
Seat 3: UTG ($5.02 in chips)
Seat 4: UTGplus1 ($12.33 in chips)
Seat 5: UTGplus2 ($4.12 in chips)
Seat 6: Dealer ($9.53 in chips)
Small Blind: posts small blind $0.02
Hero: posts big blind $0.05
*** HOLE CARDS ***
Dealt to Hero [Qh 3h]
UTG: calls $0.05 
UTGplus1: folds
UTGplus2: folds
Dealer: folds
Small Blind: folds
Hero: checks
*** FLOP *** [5h Tc 2s]
Hero: checks
UTG: bets $0.12 
Hero: folds
Uncalled bet ($0.12) returned to UTG
UTG: doesn't show hand
UTG collected $0.12 from pot
Seat re-join
*** SUMMARY ***
Total pot $0.12 | Rake $0.00
Board [5h Tc 2s]
Seat 1: Small Blind (small blind) showed
Seat 2: Hero (big blind) showed
Seat 3: UTG won ($0.12)
Seat 4: UTGplus1 showed
Seat 5: UTGplus2 showed
Seat 6: Dealer (button) showed



PokerStars Zoom Hand #3434340819: Hold'em No Limit ($0.02/$0.05) - 2017/03/08 23:05:29
Table '#952' 6-max Seat #3 is the button
Seat 1: UTGplus1 ($4.12 in chips)
Seat 2: UTGplus2 ($7.09 in chips)
Seat 3: Hero ($4.95 in chips)
Seat 4: Small Blind ($16.47 in chips)
Seat 5: Big Blind ($7.53 in chips)
Seat 6: UTG ($4.56 in chips)
Small Blind: posts small blind $0.02
Big Blind: posts big blind $0.05
*** HOLE CARDS ***
Dealt to Hero [9s Qd]
UTG: folds
UTGplus1: folds
UTGplus2: folds
Hero: raises $0.17 to $0.17
Small Blind: folds
Big Blind: folds
Uncalled bet ($0.12) returned to Hero
Hero: doesn't show hand
Hero collected $0.12 from pot
Table leave user
Table leave user
*** SUMMARY ***
Total pot $0.12 | Rake $0.00
Seat 1: UTGplus1 showed
Seat 2: UTGplus2 showed
Seat 3: Hero (button) won ($0.12)
Seat 4: Small Blind (small blind) showed
Seat 5: Big Blind (big blind) showed
Seat 6: UTG showed



PokerStars Zoom Hand #3434341021: Hold'em No Limit ($0.02/$0.05) - 2017/03/08 23:05:54
Table '#952' 6-max Seat #4 is the button
Seat 1: UTG ($3.20 in chips)
Seat 2: Hero ($5.02 in chips)
Seat 3: UTGplus2 ($6.57 in chips)
Seat 4: Dealer ($7.70 in chips)
Seat 5: Small Blind ($5.84 in chips)
Seat 6: Big Blind ($1.11 in chips)
Small Blind: posts small blind $0.02
Big Blind: posts big blind $0.05
*** HOLE CARDS ***
Dealt to Hero [Ts 3h]
UTG: folds
Hero: folds
UTGplus2: folds
Dealer: folds
Small Blind: folds
Big Blind: doesn't show hand
Big Blind collected $0.07 from pot
*** SUMMARY ***
Total pot $0.07 | Rake $0.00
Seat 1: UTG showed
Seat 2: Hero showed
Seat 3: UTGplus2 showed
Seat 4: Dealer (button) showed
Seat 5: Small Blind (small blind) showed
Seat 6: Big Blind (big blind) won ($0.07)



PokerStars Zoom Hand #3434341066: Hold'em No Limit ($0.02/$0.05) - 2017/03/08 23:05:59
Table '#952' 6-max Seat #1 is the button
Seat 1: Dealer ($9.48 in chips)
Seat 2: Small Blind ($4.80 in chips)
Seat 3: Big Blind ($18.26 in chips)
Seat 4: UTG ($3.17 in chips)
Seat 5: UTGplus1 ($15.52 in chips)
Seat 6: Hero ($5.02 in chips)
Small Blind: posts small blind $0.02
Big Blind: posts big blind $0.05
*** HOLE CARDS ***
Dealt to Hero [Qc 6c]
UTG: folds
UTGplus1: folds
Hero: folds
Dealer: folds
Small Blind: folds
Big Blind: doesn't show hand
Big Blind collected $0.07 from pot
*** SUMMARY ***
Total pot $0.07 | Rake $0.00
Seat 1: Dealer (button) showed
Seat 2: Small Blind (small blind) showed
Seat 3: Big Blind (big blind) won ($0.07)
Seat 4: UTG showed
Seat 5: UTGplus1 showed
Seat 6: Hero showed



PokerStars Zoom Hand #3434341131: Hold'em No Limit ($0.02/$0.05) - 2017/03/08 23:06:06
Table '#952' 6-max Seat #6 is the button
Seat 1: Small Blind ($9.48 in chips)
Seat 2: Big Blind ($10.47 in chips)
Seat 3: UTG ($3.55 in chips)
Seat 4: Hero ($5.02 in chips)
Seat 5: UTGplus2 ($4.56 in chips)
Seat 6: Dealer ($26.87 in chips)
Small Blind: posts small blind $0.02
Big Blind: posts big blind $0.05
*** HOLE CARDS ***
Dealt to Hero [8h Qh]
UTG: folds
Hero: raises $0.17 to $0.17
UTGplus2: folds
Dealer: calls $0.17 
Small Blind: folds
Big Blind: folds
*** FLOP *** [Kc 5s 8c]
Hero: checks
Dealer: bets $0.20 
Hero: calls $0.20 
*** TURN *** [Kc 5s 8c] [5c]
Hero: checks
Dealer: checks
*** RIVER *** [Kc 5s 8c 5c] [2c]
Hero: bets $0.60 
Dealer: calls $0.60 
*** SHOW DOWN ***
Hero: shows [8h Qh] (two pair, Eights and Kings)
Dealer: shows [Ah Jc] (a flush, King high)
Dealer collected $1.91 from pot
Table deposit $2.50 
*** SUMMARY ***
Total pot $2.01 | Rake $0.10
Board [Kc 5s 8c 5c 2c]
Seat 1: Small Blind (small blind) showed
Seat 2: Big Blind (big blind) showed
Seat 3: UTG showed
Seat 4: Hero showed [8h Qh] and lost with two pair, Eights and Kings
Seat 5: UTGplus2 showed
Seat 6: Dealer (button) showed [Ah Jc] and won ($1.91) with a flush, King high



PokerStars Zoom Hand #3434341667: Hold'em No Limit ($0.02/$0.05) - 2017/03/08 23:07:12
Table '#952' 6-max Seat #2 is the button
Seat 1: UTGplus2 ($1.92 in chips)
Seat 2: Dealer ($5.19 in chips)
Seat 3: Small Blind ($4.78 in chips)
Seat 4: Hero ($4.05 in chips)
Seat 5: UTG ($27.81 in chips)
Seat 6: UTGplus1 ($11.85 in chips)
Small Blind: posts small blind $0.02
Hero: posts big blind $0.05
*** HOLE CARDS ***
Dealt to Hero [Kd 4s]
UTG: folds 
UTGplus1: folds
UTGplus2: folds
Dealer: raises $0.15 to $0.15
UTG: Seat re-join
Small Blind: calls $0.13 
Hero: folds
*** FLOP *** [7s 8s 4d]
Small Blind: checks
Dealer: checks 
*** TURN *** [7s 8s 4d] [5s]
Small Blind: bets $0.05 
Dealer: calls $0.05 
*** RIVER *** [7s 8s 4d 5s] [Qd]
Small Blind: bets $0.11 
Dealer: folds
Uncalled bet ($0.11) returned to Small Blind
Small Blind: doesn't show hand
Small Blind collected $0.43 from pot
*** SUMMARY ***
Total pot $0.45 | Rake $0.02
Board [7s 8s 4d 5s Qd]
Seat 1: UTGplus2 showed
Seat 2: Dealer (button) showed
Seat 3: Small Blind (small blind) won ($0.43)
Seat 4: Hero (big blind) showed
Seat 5: UTG showed
Seat 6: UTGplus1 showed



PokerStars Zoom Hand #3434341937: Hold'em No Limit ($0.02/$0.05) - 2017/03/08 23:07:46
Table '#952' 6-max Seat #1 is the button
Seat 1: Hero ($5 in chips)
Seat 2: Small Blind ($10.45 in chips)
Seat 3: Big Blind ($5 in chips)
Seat 4: UTG ($4.95 in chips)
Seat 5: UTGplus1 ($1.04 in chips)
Seat 6: UTGplus2 ($5.38 in chips)
Small Blind: posts small blind $0.02
Big Blind: posts big blind $0.05
*** HOLE CARDS ***
Dealt to Hero [Th 5d]
UTG: raises $0.15 to $0.15
UTGplus1: folds
UTGplus2: folds
Hero: folds
Small Blind: folds (auth)
Small Blind: Table leave user
Big Blind: calls $0.10 
*** FLOP *** [6d Jd 5h]
Big Blind: checks
UTG: bets $0.19 
Big Blind: calls $0.19 
*** TURN *** [6d Jd 5h] [Ah]
Big Blind: bets $0.30 
UTG: folds
Uncalled bet ($0.30) returned to Big Blind
Big Blind: doesn't show hand
Big Blind collected $0.67 from pot
Table leave user
*** SUMMARY ***
Total pot $0.7 | Rake $0.03
Board [6d Jd 5h Ah]
Seat 1: Hero (button) showed
Seat 2: Small Blind (small blind) showed
Seat 3: Big Blind (big blind) won ($0.67)
Seat 4: UTG showed
Seat 5: UTGplus1 showed
Seat 6: UTGplus2 showed



PokerStars Zoom Hand #3434341990: Hold'em No Limit ($0.02/$0.05) - 2017/03/08 23:07:53
Table '#952' 6-max Seat #3 is the button
Seat 1: UTGplus1 ($5.94 in chips)
Seat 2: UTGplus2 ($4.07 in chips)
Seat 3: Dealer ($6.73 in chips)
Seat 4: Hero ($5 in chips)
Seat 5: Big Blind ($4.45 in chips)
Seat 6: UTG ($8.26 in chips)
Hero: posts small blind $0.02
Big Blind: posts big blind $0.05
*** HOLE CARDS ***
Dealt to Hero [3s Qh]
UTG: raises $0.12 to $0.12
UTGplus1: calls $0.12 
UTGplus2: folds
Dealer: folds
Hero: folds
Big Blind: folds
*** FLOP *** [6s 5d 2c]
UTG: bets $0.20 
UTGplus1: calls $0.20 
*** TURN *** [6s 5d 2c] [8d]
UTG: bets $0.25 
UTGplus1: raises $0.75 to $0.75
UTG: folds
Uncalled bet ($0.50) returned to UTGplus1
UTGplus1: doesn't show hand
UTGplus1 collected $1.15 from pot
*** SUMMARY ***
Total pot $1.21 | Rake $0.06
Board [6s 5d 2c 8d]
Seat 1: UTGplus1 won ($1.15)
Seat 2: UTGplus2 showed
Seat 3: Dealer (button) showed
Seat 4: Hero (small blind) showed
Seat 5: Big Blind (big blind) showed
Seat 6: UTG showed



PokerStars Zoom Hand #3434342026: Hold'em No Limit ($0.02/$0.05) - 2017/03/08 23:07:57
Table '#952' 6-max Seat #2 is the button
Seat 1: UTGplus2 ($4.91 in chips)
Seat 2: Dealer ($3.09 in chips)
Seat 3: Hero ($4.98 in chips)
Seat 4: Big Blind ($4.07 in chips)
Seat 5: UTG ($4.94 in chips)
Seat 6: UTGplus1 ($8.71 in chips)
Hero: posts small blind $0.02
Big Blind: posts big blind $0.05
*** HOLE CARDS ***
Dealt to Hero [4d Td]
UTG: folds
UTGplus1: folds
UTGplus2: folds
Dealer: raises $0.17 to $0.17
Hero: folds
Big Blind: raises $0.34 to $0.39
Dealer: calls $0.22 
*** FLOP *** [8s Js 3c]
Big Blind: bets $0.40 
Dealer: raises $2 to $2
Big Blind: folds
Uncalled bet ($1.60) returned to Dealer
Dealer: doesn't show hand
Dealer collected $1.52 from pot
*** SUMMARY ***
Total pot $1.6 | Rake $0.08
Board [8s Js 3c]
Seat 1: UTGplus2 showed
Seat 2: Dealer (button) won ($1.52)
Seat 3: Hero (small blind) showed
Seat 4: Big Blind (big blind) showed
Seat 5: UTG showed
Seat 6: UTGplus1 showed



PokerStars Zoom Hand #3434342086: Hold'em No Limit ($0.02/$0.05) - 2017/03/08 23:08:03
Table '#952' 6-max Seat #2 is the button
Seat 1: UTGplus2 ($2.45 in chips)
Seat 2: Dealer ($1.85 in chips)
Seat 3: Hero ($4.96 in chips)
Seat 4: Big Blind ($3.66 in chips)
Seat 5: UTG ($16.28 in chips)
Seat 6: UTGplus1 ($4.94 in chips)
Hero: posts small blind $0.02
Big Blind: posts big blind $0.05
*** HOLE CARDS ***
Dealt to Hero [9h 2c]
UTG: raises $0.20 to $0.20
UTGplus1: folds
UTGplus2: folds
Dealer: folds
Hero: folds
Big Blind: raises $0.30 to $0.35
UTG: calls $0.15 
*** FLOP *** [6h 3s As]
Big Blind: bets $0.72 
UTG: calls $0.72 
*** TURN *** [6h 3s As] [Td]
Big Blind: bets $2.16 
UTG: raises $4.62 to $4.62
Big Blind: calls $0.43 and is all-in
*** RIVER *** [6h 3s As Td] [Qs]
*** SHOW DOWN ***
Big Blind: shows [Qd Ac] (two pair, Aces and Tens)
UTG: shows [2h Ah] (a pair of Aces)
Uncalled bet ($2.03) returned to UTG
Big Blind collected $6.98 from pot
*** SUMMARY ***
Total pot $7.34 | Rake $0.36
Board [6h 3s As Td Qs]
Seat 1: UTGplus2 showed
Seat 2: Dealer (button) showed
Seat 3: Hero (small blind) showed
Seat 4: Big Blind (big blind) showed [Qd Ac] and won ($6.98) with two pair, Aces and Sixes
Seat 5: UTG showed [2h Ah] and lost with a pair of Aces
Seat 6: UTGplus1 showed



PokerStars Zoom Hand #3434342120: Hold'em No Limit ($0.02/$0.05) - 2017/03/08 23:08:08
Table '#952' 6-max Seat #4 is the button
Seat 1: UTG ($2.78 in chips)
Seat 2: UTGplus1 ($8.71 in chips)
Seat 3: UTGplus2 ($5.15 in chips)
Seat 4: Dealer ($11.70 in chips)
Seat 5: Hero ($4.94 in chips)
Seat 6: Big Blind ($2.04 in chips)
Hero: posts small blind $0.02
Big Blind: posts big blind $0.05
*** HOLE CARDS ***
Dealt to Hero [Qc Tc]
UTG: folds
UTGplus1: folds
UTGplus2: folds
Dealer: raises $0.20 to $0.20
Hero: calls $0.18 
Big Blind: raises $0.50 to $0.55
Dealer: calls $0.35 
Hero: calls $0.35 
*** FLOP *** [7h 2s 7c]
Hero: checks
Big Blind: bets $0.75 
Dealer: raises $1.50 to $1.50
Hero: folds
Big Blind: calls $0.74 and is all-in
*** TURN *** [7h 2s 7c] [Ts]
*** RIVER *** [7h 2s 7c Ts] [Ac]
*** SHOW DOWN ***
Dealer: shows [8h 8d] (two pair, Eights and Aces)
Big Blind: shows [Jc Jh] (two pair, Jacks and Aces)
Uncalled bet ($0.01) returned to Dealer
Big Blind collected $4.4 from pot
*** SUMMARY ***
Total pot $4.63 | Rake $0.23
Board [7h 2s 7c Ts Ac]
Seat 1: UTG showed
Seat 2: UTGplus1 showed
Seat 3: UTGplus2 showed
Seat 4: Dealer (button) showed [8h 8d] and lost with two pair, Eights and Aces
Seat 5: Hero (small blind) showed
Seat 6: Big Blind (big blind) showed [Jc Jh] and won ($4.4) with two pair, Jacks and Aces



PokerStars Zoom Hand #3434342774: Hold'em No Limit ($0.02/$0.05) - 2017/03/08 23:09:30
Table '#952' 6-max Seat #3 is the button
Seat 1: Hero ($5 in chips)
Seat 2: UTGplus2 ($3.99 in chips)
Seat 3: Dealer ($1.13 in chips)
Seat 4: Small Blind ($4.83 in chips)
Seat 5: Big Blind ($5.87 in chips)
Seat 6: UTG ($15.45 in chips)
Small Blind: posts small blind $0.02
Big Blind: posts big blind $0.05
*** HOLE CARDS ***
Dealt to Hero [7c Kh]
UTG: folds
Hero: folds
UTGplus2: calls $0.05 
Dealer: folds
Small Blind: folds
Big Blind: checks
*** FLOP *** [2d 8h 6c]
Big Blind: checks
UTGplus2: bets $0.10 
Big Blind: folds
Uncalled bet ($0.10) returned to UTGplus2
UTGplus2: doesn't show hand
UTGplus2 collected $0.12 from pot
*** SUMMARY ***
Total pot $0.12 | Rake $0.00
Board [2d 8h 6c]
Seat 1: Hero showed
Seat 2: UTGplus2 won ($0.12)
Seat 3: Dealer (button) showed
Seat 4: Small Blind (small blind) showed
Seat 5: Big Blind (big blind) showed
Seat 6: UTG showed



PokerStars Zoom Hand #3434342823: Hold'em No Limit ($0.02/$0.05) - 2017/03/08 23:09:36
Table '#952' 6-max Seat #6 is the button
Seat 1: Small Blind ($4.36 in chips)
Seat 2: Hero ($5 in chips)
Seat 3: UTG ($1.13 in chips)
Seat 4: UTGplus1 ($5.14 in chips)
Seat 5: UTGplus2 ($5 in chips)
Seat 6: Dealer ($5.45 in chips)
Small Blind: posts small blind $0.02
Hero: posts big blind $0.05
*** HOLE CARDS ***
Dealt to Hero [Ah 4d]
UTG: folds
UTGplus1: folds
UTGplus2: folds
Dealer: calls $0.05 
Small Blind: raises $0.13 to $0.15
Hero: calls $0.10 
Dealer: calls $0.10 
*** FLOP *** [Qc Kd Qd]
Small Blind: checks
Hero: checks
Dealer: bets $0.10 
Small Blind: calls $0.10 
Hero: folds
*** TURN *** [Qc Kd Qd] [Jc]
Small Blind: checks
Dealer: checks
*** RIVER *** [Qc Kd Qd Jc] [Ts]
Small Blind: bets $0.70 
Dealer: calls $0.70 
*** SHOW DOWN ***
Small Blind: shows [Ad Qh] (a straight, Ten to Ace)
Dealer: shows [Kh 9h] (Straight)
Small Blind collected $1.95 from pot
*** SUMMARY ***
Total pot $2.05 | Rake $0.10
Board [Qc Kd Qd Jc Ts]
Seat 1: Small Blind (small blind) showed [Ad Qh] and won ($1.95) with a straight, Ten to Ace
Seat 2: Hero (big blind) showed
Seat 3: UTG showed
Seat 4: UTGplus1 showed
Seat 5: UTGplus2 showed
Seat 6: Dealer (button) showed [Kh 9h]



PokerStars Zoom Hand #3434343170: Hold'em No Limit ($0.02/$0.05) - 2017/03/08 23:10:16
Table '#952' 6-max Seat #5 is the button
Seat 1: Big Blind ($2.68 in chips)
Seat 2: UTG ($5 in chips)
Seat 3: UTGplus1 ($4.06 in chips)
Seat 4: Hero ($4.85 in chips)
Seat 5: Dealer ($6.09 in chips)
Seat 6: Small Blind ($4.33 in chips)
Small Blind: posts small blind $0.02
Big Blind: posts big blind $0.05
*** HOLE CARDS ***
Dealt to Hero [8c 4c]
UTG: folds
UTGplus1: calls $0.05 
Hero: folds
Dealer: folds
Small Blind: folds
Big Blind: checks
*** FLOP *** [Kh 2d As]
Big Blind: checks
UTGplus1: bets $0.05 
Big Blind: calls $0.05 
*** TURN *** [Kh 2d As] [Qh]
Big Blind: checks
UTGplus1: bets $0.05 
Big Blind: raises $0.37 to $0.37
UTGplus1: calls $0.32 
*** RIVER *** [Kh 2d As Qh] [3h]
Big Blind: checks
UTGplus1: bets $0.25 
Big Blind: calls $0.25 
*** SHOW DOWN ***
UTGplus1: shows [7c Kc] (a pair of Kings)
Big Blind: shows [Jh Ts] (a straight, Ten to Ace)
Big Blind collected $1.39 from pot
Seat re-join
*** SUMMARY ***
Total pot $1.46 | Rake $0.07
Board [Kh 2d As Qh 3h]
Seat 1: Big Blind (big blind) showed [Jh Ts] and won ($1.39) with a straight, Ten to Ace
Seat 2: UTG showed
Seat 3: UTGplus1 showed [7c Kc] and lost with a pair of Kings
Seat 4: Hero showed
Seat 5: Dealer (button) showed
Seat 6: Small Blind (small blind) showed



PokerStars Zoom Hand #3434343220: Hold'em No Limit ($0.02/$0.05) - 2017/03/08 23:10:22
Table '#952' 6-max Seat #6 is the button
Seat 1: Small Blind ($1.22 in chips)
Seat 2: Big Blind ($2.75 in chips)
Seat 3: Hero ($4.85 in chips)
Seat 4: UTGplus1 ($4.65 in chips)
Seat 5: UTGplus2 ($16.54 in chips)
Seat 6: Dealer ($12.52 in chips)
Small Blind: posts small blind $0.02
Big Blind: posts big blind $0.05
*** HOLE CARDS ***
Dealt to Hero [Kh 2s]
Hero: folds
UTGplus1: folds
UTGplus2: folds
Dealer: raises $0.17 to $0.17
Small Blind: folds
Big Blind: calls $0.12 
*** FLOP *** [4c 8c 6c]
Big Blind: bets $0.36 
Dealer: calls $0.36 
*** TURN *** [4c 8c 6c] [5h]
Big Blind: checks
Dealer: checks
*** RIVER *** [4c 8c 6c 5h] [Ac]
Big Blind: checks
Dealer: bets $0.05 
Big Blind: calls $0.05 
*** SHOW DOWN ***
Dealer: shows [Jc Ad] (a flush, Ace high)
Big Blind: shows [4d 3d] (One pair)
Dealer collected $1.13 from pot
Table deposit $1.04 
*** SUMMARY ***
Total pot $1.18 | Rake $0.05
Board [4c 8c 6c 5h Ac]
Seat 1: Small Blind (small blind) showed
Seat 2: Big Blind (big blind) showed [4d 3d]
Seat 3: Hero showed
Seat 4: UTGplus1 showed
Seat 5: UTGplus2 showed
Seat 6: Dealer (button) showed [Jc Ad] and won ($1.13) with a flush, Ace high



PokerStars Zoom Hand #3434343246: Hold'em No Limit ($0.02/$0.05) - 2017/03/08 23:10:26
Table '#952' 6-max Seat #5 is the button
Seat 1: Big Blind ($4.53 in chips)
Seat 2: UTG ($5.47 in chips)
Seat 3: UTGplus1 ($13.29 in chips)
Seat 4: UTGplus2 ($1.20 in chips)
Seat 5: Dealer ($16.54 in chips)
Seat 6: Hero ($4.85 in chips)
Hero: posts small blind $0.02
Big Blind: posts big blind $0.05
*** HOLE CARDS ***
Dealt to Hero [Js 3h]
UTG: folds
UTGplus1: raises $0.15 to $0.15
UTGplus2: folds
Dealer: calls $0.15 
Hero: folds
Big Blind: folds
*** FLOP *** [8s Qd 6d]
UTGplus1: bets $0.20 
Dealer: calls $0.20 
*** TURN *** [8s Qd 6d] [4d]
UTGplus1: checks
Dealer: bets $0.77 
UTGplus1: folds
Uncalled bet ($0.77) returned to Dealer
Dealer: doesn't show hand
Dealer collected $0.74 from pot
Table deposit $5 
*** SUMMARY ***
Total pot $0.77 | Rake $0.03
Board [8s Qd 6d 4d]
Seat 1: Big Blind (big blind) showed
Seat 2: UTG showed
Seat 3: UTGplus1 showed
Seat 4: UTGplus2 showed
Seat 5: Dealer (button) won ($0.74)
Seat 6: Hero (small blind) showed



PokerStars Zoom Hand #3434343275: Hold'em No Limit ($0.02/$0.05) - 2017/03/08 23:10:30
Table '#952' 6-max Seat #2 is the button
Seat 1: UTGplus2 ($5.87 in chips)
Seat 2: Dealer ($28.02 in chips)
Seat 3: Small Blind ($1.20 in chips)
Seat 4: Big Blind ($2.65 in chips)
Seat 5: Hero ($4.83 in chips)
Seat 6: UTGplus1 ($5.52 in chips)
Small Blind: posts small blind $0.02
Big Blind: posts big blind $0.05
*** HOLE CARDS ***
Dealt to Hero [Ts 7s]
Hero: folds
UTGplus1: folds
UTGplus2: raises $0.15 to $0.15
Dealer: folds
Small Blind: folds
Big Blind: calls $0.10 
*** FLOP *** [As Ad 9d]
Big Blind: checks
UTGplus2: checks
*** TURN *** [As Ad 9d] [6h]
Big Blind: checks
UTGplus2: bets $0.20 
Big Blind: folds & shows [3c 3s] 
Uncalled bet ($0.20) returned to UTGplus2
UTGplus2: doesn't show hand
UTGplus2 collected $0.31 from pot
*** SUMMARY ***
Total pot $0.32 | Rake $0.01
Board [As Ad 9d 6h]
Seat 1: UTGplus2 won ($0.31)
Seat 2: Dealer (button) showed
Seat 3: Small Blind (small blind) showed
Seat 4: Big Blind (big blind) showed
Seat 5: Hero showed
Seat 6: UTGplus1 showed



PokerStars Zoom Hand #3434343316: Hold'em No Limit ($0.02/$0.05) - 2017/03/08 23:10:35
Table '#952' 6-max Seat #3 is the button
Seat 1: UTGplus1 ($4.30 in chips)
Seat 2: UTGplus2 ($4.39 in chips)
Seat 3: Dealer ($4.73 in chips)
Seat 4: Small Blind ($6.09 in chips)
Seat 5: Hero ($4.83 in chips)
Seat 6: UTG ($2.53 in chips)
Small Blind: posts small blind $0.02
Hero: posts big blind $0.05
*** HOLE CARDS ***
Dealt to Hero [4d 9h]
UTG: folds
UTGplus1: folds
UTGplus2: folds
Dealer: folds
Small Blind: raises $0.13 to $0.15
Hero: folds
Uncalled bet ($0.10) returned to Small Blind
Small Blind: doesn't show hand
Small Blind collected $0.1 from pot
*** SUMMARY ***
Total pot $0.1 | Rake $0.00
Seat 1: UTGplus1 showed
Seat 2: UTGplus2 showed
Seat 3: Dealer (button) showed
Seat 4: Small Blind (small blind) won ($0.1)
Seat 5: Hero (big blind) showed
Seat 6: UTG showed



PokerStars Zoom Hand #3434343350: Hold'em No Limit ($0.02/$0.05) - 2017/03/08 23:10:40
Table '#952' 6-max Seat #2 is the button
Seat 1: UTGplus2 ($13.75 in chips)
Seat 2: Hero ($4.78 in chips)
Seat 3: Small Blind ($4.75 in chips)
Seat 4: Big Blind ($5.16 in chips)
Seat 5: UTG ($5.24 in chips)
Seat 6: UTGplus1 ($5.02 in chips)
Small Blind: posts small blind $0.02
Big Blind: posts big blind $0.05
*** HOLE CARDS ***
Dealt to Hero [7s Qd]
UTG: folds
UTGplus1: raises $0.10 to $0.10
UTGplus2: folds
Hero: folds
Small Blind: calls $0.08 
Big Blind: folds
*** FLOP *** [4h As 4c]
Small Blind: checks
UTGplus1: bets $0.12 
Small Blind: calls $0.12 
*** TURN *** [4h As 4c] [8c]
Small Blind: checks
UTGplus1: bets $0.31 
Small Blind: folds
Uncalled bet ($0.31) returned to UTGplus1
UTGplus1: doesn't show hand
UTGplus1 collected $0.47 from pot
Table leave user
*** SUMMARY ***
Total pot $0.49 | Rake $0.02
Board [4h As 4c 8c]
Seat 1: UTGplus2 showed
Seat 2: Hero (button) showed
Seat 3: Small Blind (small blind) showed
Seat 4: Big Blind (big blind) showed
Seat 5: UTG showed
Seat 6: UTGplus1 won ($0.47)



PokerStars Zoom Hand #3434343379: Hold'em No Limit ($0.02/$0.05) - 2017/03/08 23:10:45
Table '#952' 6-max Seat #3 is the button
Seat 1: UTGplus1 ($5.24 in chips)
Seat 2: UTGplus2 ($5.11 in chips)
Seat 3: Hero ($4.78 in chips)
Seat 4: Small Blind ($28.02 in chips)
Seat 5: Big Blind ($4.79 in chips)
Seat 6: UTG ($4.58 in chips)
Small Blind: posts small blind $0.02
Big Blind: posts big blind $0.05
*** HOLE CARDS ***
Dealt to Hero [Qh 2d]
UTG: folds
UTGplus1: folds
UTGplus2: folds
Hero: folds
Small Blind: folds
Big Blind: doesn't show hand
Big Blind collected $0.07 from pot
Table deposit $2.53 
*** SUMMARY ***
Total pot $0.07 | Rake $0.00
Seat 1: UTGplus1 showed
Seat 2: UTGplus2 showed
Seat 3: Hero (button) showed
Seat 4: Small Blind (small blind) showed
Seat 5: Big Blind (big blind) won ($0.07)
Seat 6: UTG showed



PokerStars Zoom Hand #3434343430: Hold'em No Limit ($0.02/$0.05) - 2017/03/08 23:10:51
Table '#952' 6-max Seat #2 is the button
Seat 1: UTGplus2 ($6.39 in chips)
Seat 2: Dealer ($3.37 in chips)
Seat 3: Small Blind ($28 in chips)
Seat 4: Big Blind ($4.65 in chips)
Seat 5: UTG ($4.38 in chips)
Seat 6: Hero ($4.78 in chips)
Small Blind: posts small blind $0.02
Big Blind: posts big blind $0.05
*** HOLE CARDS ***
Dealt to Hero [Kc 9s]
UTG: folds
Hero: folds
UTGplus2: raises $0.38 to $0.38
Dealer: folds
Small Blind: folds
Big Blind: folds
*** SHOW DOWN ***
UTGplus2: shows [8h 8c] (high card Eight)
Uncalled bet ($0.33) returned to UTGplus2
UTGplus2 collected $0.12 from pot
*** SUMMARY ***
Total pot $0.12 | Rake $0.00
Seat 1: UTGplus2 collected ($0.12)
Seat 2: Dealer (button) showed
Seat 3: Small Blind (small blind) showed
Seat 4: Big Blind (big blind) showed
Seat 5: UTG showed
Seat 6: Hero showed



PokerStars Zoom Hand #3434343481: Hold'em No Limit ($0.02/$0.05) - 2017/03/08 23:10:57
Table '#952' 6-max Seat #3 is the button
Seat 1: UTGplus1 ($7.41 in chips)
Seat 2: UTGplus2 ($5.50 in chips)
Seat 3: Dealer ($4.30 in chips)
Seat 4: Hero ($4.78 in chips)
Seat 5: Big Blind ($6.14 in chips)
Seat 6: UTG ($5.11 in chips)
Hero: posts small blind $0.02
Big Blind: posts big blind $0.05
*** HOLE CARDS ***
Dealt to Hero [2c Ah]
UTG: folds
UTGplus1: folds
UTGplus2: folds
Dealer: folds
Hero: folds
Big Blind: doesn't show hand
Big Blind collected $0.07 from pot
*** SUMMARY ***
Total pot $0.07 | Rake $0.00
Seat 1: UTGplus1 showed
Seat 2: UTGplus2 showed
Seat 3: Dealer (button) showed
Seat 4: Hero (small blind) showed
Seat 5: Big Blind (big blind) won ($0.07)
Seat 6: UTG showed



PokerStars Zoom Hand #3434343517: Hold'em No Limit ($0.02/$0.05) - 2017/03/08 23:11:01
Table '#952' 6-max Seat #2 is the button
Seat 1: UTGplus2 ($5.88 in chips)
Seat 2: Dealer ($4.58 in chips)
Seat 3: Small Blind ($5.11 in chips)
Seat 4: Big Blind ($4.90 in chips)
Seat 5: UTG ($2.50 in chips)
Seat 6: Hero ($4.76 in chips)
Small Blind: posts small blind $0.02
Big Blind: posts big blind $0.05
*** HOLE CARDS ***
Dealt to Hero [9d Ac]
UTG: folds
Hero: folds
UTGplus2: folds
Dealer: folds
Small Blind: raises $0.13 to $0.15
Big Blind: folds
Uncalled bet ($0.10) returned to Small Blind
Small Blind: doesn't show hand
Small Blind collected $0.1 from pot
*** SUMMARY ***
Total pot $0.1 | Rake $0.00
Seat 1: UTGplus2 showed
Seat 2: Dealer (button) showed
Seat 3: Small Blind (small blind) won ($0.1)
Seat 4: Big Blind (big blind) showed
Seat 5: UTG showed
Seat 6: Hero showed



PokerStars Zoom Hand #3434343563: Hold'em No Limit ($0.02/$0.05) - 2017/03/08 23:11:07
Table '#952' 6-max Seat #5 is the button
Seat 1: Big Blind ($5.50 in chips)
Seat 2: UTG ($2.25 in chips)
Seat 3: UTGplus1 ($2.47 in chips)
Seat 4: UTGplus2 ($7.41 in chips)
Seat 5: Hero ($4.76 in chips)
Seat 6: Small Blind ($7.59 in chips)
Small Blind: posts small blind $0.02
Big Blind: posts big blind $0.05
*** HOLE CARDS ***
Dealt to Hero [9c 5s]
UTG: calls $0.05 
UTGplus1: folds
UTGplus2: folds
Hero: folds
Small Blind: folds
Big Blind: checks
*** FLOP *** [5h Ks 6h]
Big Blind: checks
UTG: checks
*** TURN *** [5h Ks 6h] [Th]
Big Blind: checks
UTG: checks
*** RIVER *** [5h Ks 6h Th] [4c]
Big Blind: checks
UTG: checks
*** SHOW DOWN ***
Big Blind: shows [Qd 6c] (a pair of Sixs)
UTG: shows [Ad 9d] (high card Ace)
Big Blind collected $0.12 from pot
*** SUMMARY ***
Total pot $0.12 | Rake $0.00
Board [5h Ks 6h Th 4c]
Seat 1: Big Blind (big blind) showed [Qd 6c] and won ($0.12) with a pair of Aces
Seat 2: UTG showed [Ad 9d-Ad Ks Th 9d 6h] and lost with high card Ace
Seat 3: UTGplus1 showed
Seat 4: UTGplus2 showed
Seat 5: Hero (button) showed
Seat 6: Small Blind (small blind) showed



PokerStars Zoom Hand #3434343613: Hold'em No Limit ($0.02/$0.05) - 2017/03/08 23:11:13
Table '#952' 6-max Seat #2 is the button
Seat 1: UTGplus2 ($5.88 in chips)
Seat 2: Dealer ($4.60 in chips)
Seat 3: Small Blind ($11.88 in chips)
Seat 4: Hero ($4.76 in chips)
Seat 5: UTG ($3.96 in chips)
Seat 6: UTGplus1 ($11.45 in chips)
Small Blind: posts small blind $0.02
Hero: posts big blind $0.05
*** HOLE CARDS ***
Dealt to Hero [Qd 6s]
UTG: folds
UTGplus1: folds
UTGplus2: folds
Dealer: folds
Small Blind: folds
*** SHOW DOWN ***
Hero: shows [Qd 6s] (high card Queen)
Hero collected $0.07 from pot
*** SUMMARY ***
Total pot $0.07 | Rake $0.00
Seat 1: UTGplus2 showed
Seat 2: Dealer (button) showed
Seat 3: Small Blind (small blind) showed
Seat 4: Hero (big blind) collected $0.02
Seat 5: UTG showed
Seat 6: UTGplus1 showed



PokerStars Zoom Hand #3434343648: Hold'em No Limit ($0.02/$0.05) - 2017/03/08 23:11:17
Table '#952' 6-max Seat #3 is the button
Seat 1: UTGplus1 ($6.80 in chips)
Seat 2: UTGplus2 ($5.88 in chips)
Seat 3: Dealer ($4.95 in chips)
Seat 4: Small Blind ($5.43 in chips)
Seat 5: Big Blind ($7.41 in chips)
Seat 6: Hero ($4.71 in chips)
Small Blind: posts small blind $0.02
Big Blind: posts big blind $0.05
*** HOLE CARDS ***
Dealt to Hero [6c Jh]
Hero: folds
UTGplus1: folds
UTGplus2: raises $0.15 to $0.15
Dealer: raises $0.52 to $0.52
Small Blind: folds
Big Blind: folds
UTGplus2: folds
Uncalled bet ($0.37) returned to Dealer
Dealer: doesn't show hand
Dealer collected $0.37 from pot
*** SUMMARY ***
Total pot $0.37 | Rake $0.00
Seat 1: UTGplus1 showed
Seat 2: UTGplus2 showed
Seat 3: Dealer (button) won ($0.37)
Seat 4: Small Blind (small blind) showed
Seat 5: Big Blind (big blind) showed
Seat 6: Hero showed



PokerStars Zoom Hand #3434343682: Hold'em No Limit ($0.02/$0.05) - 2017/03/08 23:11:21
Table '#952' 6-max Seat #6 is the button
Seat 1: Small Blind ($6.80 in chips)
Seat 2: Big Blind ($5.52 in chips)
Seat 3: UTG ($4.30 in chips)
Seat 4: UTGplus1 ($12.57 in chips)
Seat 5: UTGplus2 ($3.96 in chips)
Seat 6: Hero ($4.71 in chips)
Small Blind: posts small blind $0.02
Big Blind: posts big blind $0.05
*** HOLE CARDS ***
Dealt to Hero [9s 2d]
UTG: folds
UTGplus1: folds
UTGplus2: folds
Hero: folds
Small Blind: calls $0.03 
Big Blind: checks
*** FLOP *** [Ks Ac Th]
Small Blind: bets $0.05 
Big Blind: folds
Uncalled bet ($0.05) returned to Small Blind
Small Blind: doesn't show hand
Small Blind collected $0.1 from pot
*** SUMMARY ***
Total pot $0.1 | Rake $0.00
Board [Ks Ac Th]
Seat 1: Small Blind (small blind) won ($0.1)
Seat 2: Big Blind (big blind) showed
Seat 3: UTG showed
Seat 4: UTGplus1 showed
Seat 5: UTGplus2 showed
Seat 6: Hero (button) showed



PokerStars Zoom Hand #3434343720: Hold'em No Limit ($0.02/$0.05) - 2017/03/08 23:11:26
Table '#952' 6-max Seat #3 is the button
Seat 1: Hero ($4.71 in chips)
Seat 2: UTGplus2 ($2.23 in chips)
Seat 3: Dealer ($5.10 in chips)
Seat 4: Small Blind ($4.33 in chips)
Seat 5: Big Blind ($4.30 in chips)
Seat 6: UTG ($2.35 in chips)
Small Blind: posts small blind $0.02
Big Blind: posts big blind $0.05
*** HOLE CARDS ***
Dealt to Hero [2s 6d]
UTG: folds
Hero: folds
UTGplus2: folds
Dealer: folds
Small Blind: folds
Big Blind: doesn't show hand
Big Blind collected $0.07 from pot
Table leave user
*** SUMMARY ***
Total pot $0.07 | Rake $0.00
Seat 1: Hero showed
Seat 2: UTGplus2 showed
Seat 3: Dealer (button) showed
Seat 4: Small Blind (small blind) showed
Seat 5: Big Blind (big blind) won ($0.07)
Seat 6: UTG showed



PokerStars Zoom Hand #3434343760: Hold'em No Limit ($0.02/$0.05) - 2017/03/08 23:11:31
Table '#952' 6-max Seat #1 is the button
Seat 1: Dealer ($4.93 in chips)
Seat 2: Small Blind ($5.10 in chips)
Seat 3: Big Blind ($11.45 in chips)
Seat 4: Hero ($4.78 in chips)
Seat 5: UTGplus1 ($8.23 in chips)
Seat 6: UTGplus2 ($4.70 in chips)
Small Blind: posts small blind $0.02
Big Blind: posts big blind $0.05
*** HOLE CARDS ***
Dealt to Hero [Kc 9d]
Hero: folds
UTGplus1: folds
UTGplus2: folds
Dealer: raises $0.15 to $0.15
Small Blind: calls $0.13 
Big Blind: raises $0.45 to $0.50
Dealer: calls $0.35 
Small Blind: folds
*** FLOP *** [9c 6s Jh]
Big Blind: bets $0.40 
Dealer: calls $0.40 
*** TURN *** [9c 6s Jh] [2h]
Big Blind: checks
Dealer: bets $1.02 
Big Blind: folds 
Uncalled bet ($1.02) returned to Dealer
Dealer: doesn't show hand
Dealer collected $1.86 from pot
UTGplus1: Seat re-join
*** SUMMARY ***
Total pot $1.95 | Rake $0.09
Board [9c 6s Jh 2h]
Seat 1: Dealer (button) won ($1.86)
Seat 2: Small Blind (small blind) showed
Seat 3: Big Blind (big blind) showed
Seat 4: Hero showed
Seat 5: UTGplus1 showed
Seat 6: UTGplus2 showed



PokerStars Zoom Hand #3434343817: Hold'em No Limit ($0.02/$0.05) - 2017/03/08 23:11:38
Table '#952' 6-max Seat #5 is the button
Seat 1: Big Blind ($4.31 in chips)
Seat 2: UTG ($16.93 in chips)
Seat 3: UTGplus1 ($4.60 in chips)
Seat 4: UTGplus2 ($7.91 in chips)
Seat 5: Hero ($4.78 in chips)
Seat 6: Small Blind ($2.57 in chips)
Small Blind: posts small blind $0.02
Big Blind: posts big blind $0.05
*** HOLE CARDS ***
Dealt to Hero [8d 9c]
UTG: calls $0.05 
UTGplus1: raises $0.27 to $0.27
UTGplus2: folds
Hero: folds
Small Blind: folds
Big Blind: folds
UTG: folds
Uncalled bet ($0.22) returned to UTGplus1
UTGplus1: doesn't show hand
UTGplus1 collected $0.17 from pot
*** SUMMARY ***
Total pot $0.17 | Rake $0.00
Seat 1: Big Blind (big blind) showed
Seat 2: UTG showed
Seat 3: UTGplus1 won ($0.17)
Seat 4: UTGplus2 showed
Seat 5: Hero (button) showed
Seat 6: Small Blind (small blind) showed



PokerStars Zoom Hand #3434343930: Hold'em No Limit ($0.02/$0.05) - 2017/03/08 23:11:53
Table '#952' 6-max Seat #2 is the button
Seat 1: UTGplus2 ($7.52 in chips)
Seat 2: Dealer ($3.14 in chips)
Seat 3: Small Blind ($8.07 in chips)
Seat 4: Hero ($4.78 in chips)
Seat 5: UTG ($5.47 in chips)
Seat 6: UTGplus1 ($6.14 in chips)
Small Blind: posts small blind $0.02
Hero: posts big blind $0.05
*** HOLE CARDS ***
Dealt to Hero [9d 5d]
UTG: folds
UTGplus1: folds
UTGplus2: folds
Dealer: folds
Small Blind: raises $0.13 to $0.15
Hero: calls $0.10 
*** FLOP *** [Qd 6s Ad]
Small Blind: bets $0.17 
Hero: calls $0.17 
*** TURN *** [Qd 6s Ad] [2d]
Small Blind: bets $0.44 
Hero: calls $0.44 
*** RIVER *** [Qd 6s Ad 2d] [Tc]
Small Blind: bets $1.04 
Hero: calls $1.04 
*** SHOW DOWN ***
Small Blind: shows [Kd Jc] (a straight, Ten to Ace)
Hero: shows [9d 5d] (a flush, Ace high)
Hero collected $3.42 from pot
*** SUMMARY ***
Total pot $3.6 | Rake $0.18
Board [Qd 6s Ad 2d Tc]
Seat 1: UTGplus2 showed
Seat 2: Dealer (button) showed
Seat 3: Small Blind (small blind) showed [Kd Jc] and lost with a straight, Ten to Ace
Seat 4: Hero (big blind) showed [9d 5d] and won ($3.42) with a flush, Ace high
Seat 5: UTG showed
Seat 6: UTGplus1 showed



PokerStars Zoom Hand #3434344474: Hold'em No Limit ($0.02/$0.05) - 2017/03/08 23:13:01
Table '#952' 6-max Seat #5 is the button
Seat 1: Big Blind ($4.56 in chips)
Seat 2: UTG ($8.75 in chips)
Seat 3: UTGplus1 ($7.13 in chips)
Seat 4: Hero ($6.40 in chips)
Seat 5: Dealer ($6.37 in chips)
Seat 6: Small Blind ($4.95 in chips)
Small Blind: posts small blind $0.02
Big Blind: posts big blind $0.05
*** HOLE CARDS ***
Dealt to Hero [5d Qc]
UTG: folds
UTGplus1: folds
Hero: folds
Dealer: raises $0.15 to $0.15
Small Blind: folds
Big Blind: calls $0.10 
*** FLOP *** [As 4c Js]
Big Blind: checks
Dealer: checks
*** TURN *** [As 4c Js] [4h]
Big Blind: bets $0.13 
Dealer: folds
Uncalled bet ($0.13) returned to Big Blind
Big Blind: doesn't show hand
Big Blind collected $0.31 from pot
Small Blind: Seat re-join
Table deposit $2.50 
*** SUMMARY ***
Total pot $0.32 | Rake $0.01
Board [As 4c Js 4h]
Seat 1: Big Blind (big blind) won ($0.31)
Seat 2: UTG showed
Seat 3: UTGplus1 showed
Seat 4: Hero showed
Seat 5: Dealer (button) showed
Seat 6: Small Blind (small blind) showed



PokerStars Zoom Hand #3434344538: Hold'em No Limit ($0.02/$0.05) - 2017/03/08 23:13:08
Table '#952' 6-max Seat #1 is the button
Seat 1: Dealer ($8.17 in chips)
Seat 2: Hero ($6.40 in chips)
Seat 3: Big Blind ($4.53 in chips)
Seat 4: UTG ($12.16 in chips)
Seat 5: UTGplus1 ($5.83 in chips)
Seat 6: UTGplus2 ($9.09 in chips)
Hero: posts small blind $0.02
Big Blind: posts big blind $0.05
*** HOLE CARDS ***
Dealt to Hero [Kc Js]
UTG: folds
UTGplus1: folds 
UTGplus2: folds
UTGplus1: Seat re-join
Dealer: raises $0.10 to $0.10
Hero: calls $0.08 
Big Blind: calls $0.05 
*** FLOP *** [Jd 7s 9s]
Hero: checks
Big Blind: checks
Dealer: checks
*** TURN *** [Jd 7s 9s] [3s]
Hero: bets $0.20 
Big Blind: folds
Dealer: folds
Uncalled bet ($0.20) returned to Hero
Hero: doesn't show hand
Hero collected $0.29 from pot
Table deposit $2.50 
*** SUMMARY ***
Total pot $0.3 | Rake $0.01
Board [Jd 7s 9s 3s]
Seat 1: Dealer (button) showed
Seat 2: Hero (small blind) won ($0.29)
Seat 3: Big Blind (big blind) showed
Seat 4: UTG showed
Seat 5: UTGplus1 showed
Seat 6: UTGplus2 showed



PokerStars Zoom Hand #3434345133: Hold'em No Limit ($0.02/$0.05) - 2017/03/08 23:14:26
Table '#952' 6-max Seat #5 is the button
Seat 1: Big Blind ($17.93 in chips)
Seat 2: UTG ($4.57 in chips)
Seat 3: UTGplus1 ($3.85 in chips)
Seat 4: Hero ($6.59 in chips)
Seat 5: Dealer ($3.99 in chips)
Seat 6: Small Blind ($1.90 in chips)
Small Blind: posts small blind $0.02
Big Blind: posts big blind $0.05
*** HOLE CARDS ***
Dealt to Hero [3c Qs]
UTG: folds
UTGplus1: folds
Hero: folds
Dealer: folds
Small Blind: calls $0.03 
Big Blind: checks
*** FLOP *** [9h 6s 3d]
Small Blind: bets $0.15 
Big Blind: folds
Uncalled bet ($0.15) returned to Small Blind
Small Blind: doesn't show hand
Small Blind collected $0.1 from pot
Table deposit $0.09 
*** SUMMARY ***
Total pot $0.1 | Rake $0.00
Board [9h 6s 3d]
Seat 1: Big Blind (big blind) showed
Seat 2: UTG showed
Seat 3: UTGplus1 showed
Seat 4: Hero showed
Seat 5: Dealer (button) showed
Seat 6: Small Blind (small blind) won ($0.1)



PokerStars Zoom Hand #3434345176: Hold'em No Limit ($0.02/$0.05) - 2017/03/08 23:14:32
Table '#952' 6-max Seat #4 is the button
Seat 1: UTG ($2.38 in chips)
Seat 2: Hero ($6.59 in chips)
Seat 3: UTGplus2 ($8.07 in chips)
Seat 4: Dealer ($4.88 in chips)
Seat 5: Small Blind ($11.30 in chips)
Seat 6: Big Blind ($5.11 in chips)
Small Blind: posts small blind $0.02
Big Blind: posts big blind $0.05
*** HOLE CARDS ***
Dealt to Hero [Jd 5h]
UTG: folds
Hero: folds
UTGplus2: folds
Dealer: raises $0.18 to $0.18
Small Blind: raises $0.57 to $0.59
Big Blind: folds
Dealer: folds
Uncalled bet ($0.41) returned to Small Blind
Small Blind: doesn't show hand
Small Blind collected $0.41 from pot
Table deposit $1.14 
*** SUMMARY ***
Total pot $0.41 | Rake $0.00
Seat 1: UTG showed
Seat 2: Hero showed
Seat 3: UTGplus2 showed
Seat 4: Dealer (button) showed
Seat 5: Small Blind (small blind) won ($0.41)
Seat 6: Big Blind (big blind) showed



PokerStars Zoom Hand #3434345228: Hold'em No Limit ($0.02/$0.05) - 2017/03/08 23:14:37
Table '#952' 6-max Seat #6 is the button
Seat 1: Small Blind ($6.26 in chips)
Seat 2: Big Blind ($4.69 in chips)
Seat 3: UTG ($8.40 in chips)
Seat 4: UTGplus1 ($23.75 in chips)
Seat 5: UTGplus2 ($6.25 in chips)
Seat 6: Hero ($6.59 in chips)
Small Blind: posts small blind $0.02
Big Blind: posts big blind $0.05
*** HOLE CARDS ***
Dealt to Hero [Tc Th]
UTG: folds
UTGplus1: folds
UTGplus2: folds
Hero: raises $0.17 to $0.17
Small Blind: folds
Big Blind: calls $0.12 
*** FLOP *** [3c 4d 3s]
Big Blind: checks
Hero: bets $0.23 
Big Blind: calls $0.23 
*** TURN *** [3c 4d 3s] [2d]
Big Blind: checks
Hero: checks
*** RIVER *** [3c 4d 3s 2d] [Qs]
Big Blind: bets $0.41 
Hero: calls $0.41 
*** SHOW DOWN ***
Big Blind: shows [8h Kh] (a pair of Threes)
Hero: shows [Tc Th] (two pair, Tens and Queens)
Hero collected $1.56 from pot
*** SUMMARY ***
Total pot $1.64 | Rake $0.08
Board [3c 4d 3s 2d Qs]
Seat 1: Small Blind (small blind) showed
Seat 2: Big Blind (big blind) showed [8h Kh] and lost with a pair of Threes
Seat 3: UTG showed
Seat 4: UTGplus1 showed
Seat 5: UTGplus2 showed
Seat 6: Hero (button) showed [Tc Th] and won ($1.56) with two pair, Tens and Queens



PokerStars Zoom Hand #3434345664: Hold'em No Limit ($0.02/$0.05) - 2017/03/08 23:15:36
Table '#952' 6-max Seat #2 is the button
Seat 1: UTGplus2 ($8.33 in chips)
Seat 2: Dealer ($6.37 in chips)
Seat 3: Small Blind ($3.88 in chips)
Seat 4: Hero ($7.34 in chips)
Seat 5: UTG ($2.48 in chips)
Seat 6: UTGplus1 ($4.34 in chips)
Small Blind: posts small blind $0.02
Hero: posts big blind $0.05
*** HOLE CARDS ***
Dealt to Hero [5s 5d]
UTG: folds
UTGplus1: folds
UTGplus2: raises $0.15 to $0.15
Dealer: folds
Small Blind: folds
Hero: calls $0.10 
*** FLOP *** [2c Th Ac]
Hero: checks
UTGplus2: checks
*** TURN *** [2c Th Ac] [8s]
Hero: checks
UTGplus2: bets $0.21 
Hero: folds
Uncalled bet ($0.21) returned to UTGplus2
UTGplus2: doesn't show hand
UTGplus2 collected $0.31 from pot
*** SUMMARY ***
Total pot $0.32 | Rake $0.01
Board [2c Th Ac 8s]
Seat 1: UTGplus2 won ($0.31)
Seat 2: Dealer (button) showed
Seat 3: Small Blind (small blind) showed
Seat 4: Hero (big blind) showed
Seat 5: UTG showed
Seat 6: UTGplus1 showed



PokerStars Zoom Hand #3434346003: Hold'em No Limit ($0.02/$0.05) - 2017/03/08 23:16:16
Table '#952' 6-max Seat #6 is the button
Seat 1: Hero ($7.19 in chips)
Seat 2: Big Blind ($1.80 in chips)
Seat 3: UTG ($5.97 in chips)
Seat 4: UTGplus1 ($2.16 in chips)
Seat 5: UTGplus2 ($5.06 in chips)
Seat 6: Dealer ($4.95 in chips)
Hero: posts small blind $0.02
Big Blind: posts big blind $0.05
*** HOLE CARDS ***
Dealt to Hero [Qs 4d]
UTG: folds
UTGplus1: folds
UTGplus2: folds
Dealer: folds
Hero: raises $0.13 to $0.15
Big Blind: folds
Uncalled bet ($0.10) returned to Hero
Hero: doesn't show hand
Hero collected $0.1 from pot
*** SUMMARY ***
Total pot $0.1 | Rake $0.00
Seat 1: Hero (small blind) won ($0.1)
Seat 2: Big Blind (big blind) showed
Seat 3: UTG showed
Seat 4: UTGplus1 showed
Seat 5: UTGplus2 showed
Seat 6: Dealer (button) showed



PokerStars Zoom Hand #3434346171: Hold'em No Limit ($0.02/$0.05) - 2017/03/08 23:16:38
Table '#952' 6-max Seat #5 is the button
Seat 1: Big Blind ($7.33 in chips)
Seat 2: UTG ($4.24 in chips)
Seat 3: UTGplus1 ($4.56 in chips)
Seat 4: UTGplus2 ($5.57 in chips)
Seat 5: Dealer ($10.29 in chips)
Seat 6: Hero ($7.24 in chips)
Hero: posts small blind $0.02
Big Blind: posts big blind $0.05
*** HOLE CARDS ***
Dealt to Hero [5c 4d]
UTG: folds
UTGplus1: folds
UTGplus2: folds
Dealer: folds
Hero: raises $0.13 to $0.15
Big Blind: folds
Uncalled bet ($0.10) returned to Hero
Hero: doesn't show hand
Hero collected $0.1 from pot
*** SUMMARY ***
Total pot $0.1 | Rake $0.00
Seat 1: Big Blind (big blind) showed
Seat 2: UTG showed
Seat 3: UTGplus1 showed
Seat 4: UTGplus2 showed
Seat 5: Dealer (button) showed
Seat 6: Hero (small blind) won ($0.1)



PokerStars Zoom Hand #3434346354: Hold'em No Limit ($0.02/$0.05) - 2017/03/08 23:16:59
Table '#952' 6-max Seat #5 is the button
Seat 1: Big Blind ($5 in chips)
Seat 2: UTG ($9.72 in chips)
Seat 3: UTGplus1 ($6.92 in chips)
Seat 4: Hero ($7.29 in chips)
Seat 5: Dealer ($4.95 in chips)
Seat 6: Small Blind ($4.24 in chips)
Small Blind: posts small blind $0.02
Big Blind: posts big blind $0.05
*** HOLE CARDS ***
Dealt to Hero [3h 9s]
UTG: folds
UTGplus1: folds
Hero: folds
Dealer: folds
Small Blind: calls $0.03 
Big Blind: checks
*** FLOP *** [6c 3s 4c]
Small Blind: checks
Big Blind: checks
*** TURN *** [6c 3s 4c] [Qd]
Small Blind: bets $0.10 
Big Blind: folds
Uncalled bet ($0.10) returned to Small Blind
Small Blind: doesn't show hand
Small Blind collected $0.1 from pot
*** SUMMARY ***
Total pot $0.1 | Rake $0.00
Board [6c 3s 4c Qd]
Seat 1: Big Blind (big blind) showed
Seat 2: UTG showed
Seat 3: UTGplus1 showed
Seat 4: Hero showed
Seat 5: Dealer (button) showed
Seat 6: Small Blind (small blind) won ($0.1)



PokerStars Zoom Hand #3434346433: Hold'em No Limit ($0.02/$0.05) - 2017/03/08 23:17:08
Table '#952' 6-max Seat #2 is the button
Seat 1: UTGplus2 ($6.20 in chips)
Seat 2: Hero ($7.29 in chips)
Seat 3: Small Blind ($7.74 in chips)
Seat 4: Big Blind ($10.34 in chips)
Seat 5: UTG ($4.70 in chips)
Seat 6: UTGplus1 ($6.43 in chips)
Small Blind: posts small blind $0.02
Big Blind: posts big blind $0.05
*** HOLE CARDS ***
Dealt to Hero [5d 9s]
UTG: folds
UTGplus1: raises $0.15 to $0.15
UTGplus2: calls $0.15 
Hero: folds
Small Blind: folds
Big Blind: folds
*** FLOP *** [4d Ad 8s]
UTGplus1: bets $0.18 
UTGplus2: calls $0.18 
*** TURN *** [4d Ad 8s] [Kc]
UTGplus1: checks
UTGplus2: checks
*** RIVER *** [4d Ad 8s Kc] [Ac]
UTGplus1: bets $0.78 
UTGplus2: folds
Uncalled bet ($0.78) returned to UTGplus1
UTGplus1: doesn't show hand
UTGplus1 collected $0.7 from pot
*** SUMMARY ***
Total pot $0.73 | Rake $0.03
Board [4d Ad 8s Kc Ac]
Seat 1: UTGplus2 showed
Seat 2: Hero (button) showed
Seat 3: Small Blind (small blind) showed
Seat 4: Big Blind (big blind) showed
Seat 5: UTG showed
Seat 6: UTGplus1 won ($0.7)



PokerStars Zoom Hand #3434346472: Hold'em No Limit ($0.02/$0.05) - 2017/03/08 23:17:13
Table '#952' 6-max Seat #5 is the button
Seat 1: Big Blind ($4.36 in chips)
Seat 2: UTG ($4.70 in chips)
Seat 3: UTGplus1 ($1.80 in chips)
Seat 4: Hero ($7.29 in chips)
Seat 5: Dealer ($4.35 in chips)
Seat 6: Small Blind ($12.77 in chips)
Small Blind: posts small blind $0.02
Big Blind: posts big blind $0.05
*** HOLE CARDS ***
Dealt to Hero [3c 8s]
UTG: folds
UTGplus1: raises $0.15 to $0.15
Hero: folds
Dealer: folds
Small Blind: folds
Big Blind: calls $0.10 
*** FLOP *** [9d 2c 4s]
Big Blind: checks
UTGplus1: checks
*** TURN *** [9d 2c 4s] [Kh]
Big Blind: checks
UTGplus1: bets $0.25 
Big Blind: folds
Uncalled bet ($0.25) returned to UTGplus1
UTGplus1: doesn't show hand
UTGplus1 collected $0.31 from pot
Table deposit $2.50 
*** SUMMARY ***
Total pot $0.32 | Rake $0.01
Board [9d 2c 4s Kh]
Seat 1: Big Blind (big blind) showed
Seat 2: UTG showed
Seat 3: UTGplus1 won ($0.31)
Seat 4: Hero showed
Seat 5: Dealer (button) showed
Seat 6: Small Blind (small blind) showed



PokerStars Zoom Hand #3434346515: Hold'em No Limit ($0.02/$0.05) - 2017/03/08 23:17:19
Table '#952' 6-max Seat #6 is the button
Seat 1: Small Blind ($10.29 in chips)
Seat 2: Hero ($7.29 in chips)
Seat 3: UTG ($6.66 in chips)
Seat 4: UTGplus1 ($4.67 in chips)
Seat 5: UTGplus2 ($5.95 in chips)
Seat 6: Dealer ($9.29 in chips)
Small Blind: posts small blind $0.02
Hero: posts big blind $0.05
*** HOLE CARDS ***
Dealt to Hero [Ah Qc]
UTG: folds
UTGplus1: folds
UTGplus2: folds
Dealer: raises $0.15 to $0.15
Small Blind: folds
Hero: raises $0.42 to $0.47
Dealer: folds
Uncalled bet ($0.32) returned to Hero
Hero: doesn't show hand
Hero collected $0.32 from pot
*** SUMMARY ***
Total pot $0.32 | Rake $0.00
Seat 1: Small Blind (small blind) showed
Seat 2: Hero (big blind) won ($0.32)
Seat 3: UTG showed
Seat 4: UTGplus1 showed
Seat 5: UTGplus2 showed
Seat 6: Dealer (button) showed



PokerStars Zoom Hand #3434346747: Hold'em No Limit ($0.02/$0.05) - 2017/03/08 23:17:48
Table '#952' 6-max Seat #2 is the button
Seat 1: UTGplus2 ($2.50 in chips)
Seat 2: Hero ($7.46 in chips)
Seat 3: Small Blind ($4.07 in chips)
Seat 4: Big Blind ($6.36 in chips)
Seat 5: UTG ($4.30 in chips)
Seat 6: UTGplus1 ($5.12 in chips)
Small Blind: posts small blind $0.02
Big Blind: posts big blind $0.05
*** HOLE CARDS ***
Dealt to Hero [5d 9h]
UTG: folds
UTGplus1: folds
UTGplus2: calls $0.05 
Hero: folds
Small Blind: folds
Big Blind: checks
*** FLOP *** [2c Tc Jd]
Big Blind: bets $0.05 
UTGplus2: calls $0.05 
*** TURN *** [2c Tc Jd] [Kd]
Big Blind: bets $0.10 
UTGplus2: calls $0.10 
*** RIVER *** [2c Tc Jd Kd] [4d]
Big Blind: checks
UTGplus2: checks
*** SHOW DOWN ***
Big Blind: shows [Th 3d] (a pair of Tens)
UTGplus2: shows [3s 3c] (a pair of Threes)
Big Blind collected $0.4 from pot
*** SUMMARY ***
Total pot $0.42 | Rake $0.02
Board [2c Tc Jd Kd 4d]
Seat 1: UTGplus2 showed [3s 3c] and lost with a pair of Threes
Seat 2: Hero (button) showed
Seat 3: Small Blind (small blind) showed
Seat 4: Big Blind (big blind) showed [Th 3d] and won ($0.4) with a pair of Threes
Seat 5: UTG showed
Seat 6: UTGplus1 showed



PokerStars Zoom Hand #3434346806: Hold'em No Limit ($0.02/$0.05) - 2017/03/08 23:17:56
Table '#952' 6-max Seat #1 is the button
Seat 1: Dealer ($7.01 in chips)
Seat 2: Small Blind ($17.02 in chips)
Seat 3: Big Blind ($5.12 in chips)
Seat 4: UTG ($3.30 in chips)
Seat 5: UTGplus1 ($3.88 in chips)
Seat 6: Hero ($7.46 in chips)
Small Blind: posts small blind $0.02
Big Blind: posts big blind $0.05
*** HOLE CARDS ***
Dealt to Hero [Ah 3h]
UTG: folds
UTGplus1: folds
Hero: raises $0.17 to $0.17
Dealer: folds
Small Blind: folds
Big Blind: folds
Uncalled bet ($0.12) returned to Hero
Hero: doesn't show hand
Hero collected $0.12 from pot
Table leave user
*** SUMMARY ***
Total pot $0.12 | Rake $0.00
Seat 1: Dealer (button) showed
Seat 2: Small Blind (small blind) showed
Seat 3: Big Blind (big blind) showed
Seat 4: UTG showed
Seat 5: UTGplus1 showed
Seat 6: Hero won ($0.12)



PokerStars Zoom Hand #3434346999: Hold'em No Limit ($0.02/$0.05) - 2017/03/08 23:18:18
Table '#952' 6-max Seat #4 is the button
Seat 1: UTG ($7.16 in chips)
Seat 2: UTGplus1 ($5.13 in chips)
Seat 3: UTGplus2 ($23.46 in chips)
Seat 4: Dealer ($1.59 in chips)
Seat 5: Hero ($7.53 in chips)
Seat 6: Big Blind ($4.91 in chips)
Hero: posts small blind $0.02
Big Blind: posts big blind $0.05
*** HOLE CARDS ***
Dealt to Hero [6h 4d]
UTG: raises $0.10 to $0.10
UTGplus1: folds
UTGplus2: raises $0.30 to $0.30
Dealer: raises $1.56 to $1.56
Hero: folds
Big Blind: folds
UTG: folds
UTGplus2: raises $2.52 to $2.82
Dealer: calls $0.03 and is all-in
*** FLOP *** [4h 3s 5h]
*** TURN *** [4h 3s 5h] [2s]
*** RIVER *** [4h 3s 5h 2s] [7s]
*** SHOW DOWN ***
UTGplus2: shows [Ks As] (a flush, Ace high)
Dealer: shows [Jh Qs] (high card Queen)
Uncalled bet ($1.23) returned to UTGplus2
UTGplus2 collected $3.19 from pot
*** SUMMARY ***
Total pot $3.35 | Rake $0.16
Board [4h 3s 5h 2s 7s]
Seat 1: UTG showed
Seat 2: UTGplus1 showed
Seat 3: UTGplus2 showed [Ks As] and won ($3.19) with a flush, Queen high
Seat 4: Dealer (button) showed [Jh Qs-Qs Jh 7s 5h 4h] and lost with high card Jack
Seat 5: Hero (small blind) showed
Seat 6: Big Blind (big blind) showed



PokerStars Zoom Hand #3434347095: Hold'em No Limit ($0.02/$0.05) - 2017/03/08 23:18:31
Table '#952' 6-max Seat #5 is the button
Seat 1: Big Blind ($4.68 in chips)
Seat 2: UTG ($6.86 in chips)
Seat 3: UTGplus1 ($8.60 in chips)
Seat 4: Hero ($7.51 in chips)
Seat 5: Dealer ($2.31 in chips)
Seat 6: Small Blind ($12.53 in chips)
Small Blind: posts small blind $0.02
Big Blind: posts big blind $0.05
*** HOLE CARDS ***
Dealt to Hero [2c 7c]
UTG: folds
UTGplus1: folds
Hero: folds
Dealer: folds
Small Blind: folds
Big Blind: doesn't show hand
Big Blind collected $0.07 from pot
Table deposit $5 
*** SUMMARY ***
Total pot $0.07 | Rake $0.00
Seat 1: Big Blind (big blind) won ($0.07)
Seat 2: UTG showed
Seat 3: UTGplus1 showed
Seat 4: Hero showed
Seat 5: Dealer (button) showed
Seat 6: Small Blind (small blind) showed



PokerStars Zoom Hand #3434347182: Hold'em No Limit ($0.02/$0.05) - 2017/03/08 23:18:40
Table '#952' 6-max Seat #6 is the button
Seat 1: Small Blind ($8.60 in chips)
Seat 2: Big Blind ($6.44 in chips)
Seat 3: UTG ($4.84 in chips)
Seat 4: UTGplus1 ($5.98 in chips)
Seat 5: Hero ($7.51 in chips)
Seat 6: Dealer ($4.76 in chips)
Small Blind: posts small blind $0.02
Big Blind: posts big blind $0.05
*** HOLE CARDS ***
Dealt to Hero [9d Qs]
UTG: raises $0.15 to $0.15
UTGplus1: folds
Hero: folds
Dealer: folds
Small Blind: calls $0.13 
Big Blind: folds
*** FLOP *** [4s 5d 3s]
Small Blind: checks
UTG: bets $0.20 
Small Blind: raises $0.55 to $0.55
UTG: folds
Uncalled bet ($0.35) returned to Small Blind
Small Blind: doesn't show hand
Small Blind collected $0.72 from pot
*** SUMMARY ***
Total pot $0.75 | Rake $0.03
Board [4s 5d 3s]
Seat 1: Small Blind (small blind) won ($0.72)
Seat 2: Big Blind (big blind) showed
Seat 3: UTG showed
Seat 4: UTGplus1 showed
Seat 5: Hero showed
Seat 6: Dealer (button) showed



PokerStars Zoom Hand #3434347242: Hold'em No Limit ($0.02/$0.05) - 2017/03/08 23:18:48
Table '#952' 6-max Seat #6 is the button
Seat 1: Small Blind ($4.94 in chips)
Seat 2: Big Blind ($12.51 in chips)
Seat 3: Hero ($7.51 in chips)
Seat 4: UTGplus1 ($4.70 in chips)
Seat 5: UTGplus2 ($5.29 in chips)
Seat 6: Dealer ($4.86 in chips)
Small Blind: posts small blind $0.02
Big Blind: posts big blind $0.05
*** HOLE CARDS ***
Dealt to Hero [3s Jd]
Hero: folds
UTGplus1: folds
UTGplus2: raises $0.15 to $0.15
Dealer: folds
Small Blind: folds
Big Blind: folds
Uncalled bet ($0.10) returned to UTGplus2
UTGplus2: doesn't show hand
UTGplus2 collected $0.12 from pot
Table leave user
*** SUMMARY ***
Total pot $0.12 | Rake $0.00
Seat 1: Small Blind (small blind) showed
Seat 2: Big Blind (big blind) showed
Seat 3: Hero showed
Seat 4: UTGplus1 showed
Seat 5: UTGplus2 won ($0.12)
Seat 6: Dealer (button) showed



PokerStars Zoom Hand #3434347292: Hold'em No Limit ($0.02/$0.05) - 2017/03/08 23:18:53
Table '#952' 6-max Seat #6 is the button
Seat 1: Small Blind ($4.92 in chips)
Seat 2: Hero ($7.51 in chips)
Seat 3: UTG ($2.75 in chips)
Seat 4: UTGplus1 ($5.50 in chips)
Seat 5: UTGplus2 ($7.06 in chips)
Seat 6: Dealer ($5.16 in chips)
Small Blind: posts small blind $0.02
Hero: posts big blind $0.05
*** HOLE CARDS ***
Dealt to Hero [Qd Kh]
UTG: raises $0.22 to $0.22
UTGplus1: folds
UTGplus2: folds
Dealer: folds
Small Blind: folds
Hero: calls $0.17 
*** FLOP *** [Ah 3c Td]
Hero: checks
UTG: bets $0.12 
Hero: calls $0.12 
*** TURN *** [Ah 3c Td] [2d]
Hero: checks
UTG: checks
*** RIVER *** [Ah 3c Td 2d] [9c]
Hero: checks
UTG: checks
*** SHOW DOWN ***
Hero: shows [Qd Kh] (high card Ace)
UTG: shows [Ks Qh] (high card Ace)
Hero collected $0.34 from pot
UTG collected $0.33 from pot
*** SUMMARY ***
Total pot $0.7 | Rake $0.03
Board [Ah 3c Td 2d 9c]
Seat 1: Small Blind (small blind) showed
Seat 2: Hero (big blind) showed [Qd Kh] and won ($0.34) with high card Ace
Seat 3: UTG showed [Ks Qh] and won ($0.33) with high card Ace
Seat 4: UTGplus1 showed
Seat 5: UTGplus2 showed
Seat 6: Dealer (button) showed



PokerStars Zoom Hand #3434347813: Hold'em No Limit ($0.02/$0.05) - 2017/03/08 23:19:58
Table '#952' 6-max Seat #2 is the button
Seat 1: UTGplus2 ($1.91 in chips)
Seat 2: Dealer ($4.78 in chips)
Seat 3: Small Blind ($2.45 in chips)
Seat 4: Big Blind ($9.06 in chips)
Seat 5: Hero ($7.51 in chips)
Seat 6: UTGplus1 ($2.74 in chips)
Small Blind: posts small blind $0.02
Big Blind: posts big blind $0.05
*** HOLE CARDS ***
Dealt to Hero [8s 3s]
Hero: folds
UTGplus1: folds
UTGplus2: folds 
Dealer: folds
UTGplus2: Seat re-join
Small Blind: raises $0.13 to $0.15
Big Blind: raises $0.40 to $0.45
Small Blind: folds
Uncalled bet ($0.30) returned to Big Blind
Big Blind: doesn't show hand
Big Blind collected $0.3 from pot
*** SUMMARY ***
Total pot $0.3 | Rake $0.00
Seat 1: UTGplus2 showed
Seat 2: Dealer (button) showed
Seat 3: Small Blind (small blind) showed
Seat 4: Big Blind (big blind) won ($0.3)
Seat 5: Hero showed
Seat 6: UTGplus1 showed



PokerStars Zoom Hand #3434347862: Hold'em No Limit ($0.02/$0.05) - 2017/03/08 23:20:04
Table '#952' 6-max Seat #1 is the button
Seat 1: Dealer ($5.31 in chips)
Seat 2: Small Blind ($5.37 in chips)
Seat 3: Big Blind ($13.59 in chips)
Seat 4: UTG ($9.63 in chips)
Seat 5: Hero ($7.51 in chips)
Seat 6: UTGplus2 ($4.78 in chips)
Small Blind: posts small blind $0.02
Big Blind: posts big blind $0.05
*** HOLE CARDS ***
Dealt to Hero [2d Ad]
UTG: folds
Hero: folds
UTGplus2: folds
Dealer: raises $0.15 to $0.15
Small Blind: folds
Big Blind: folds
Uncalled bet ($0.10) returned to Dealer
Dealer: doesn't show hand
Dealer collected $0.12 from pot
*** SUMMARY ***
Total pot $0.12 | Rake $0.00
Seat 1: Dealer (button) won ($0.12)
Seat 2: Small Blind (small blind) showed
Seat 3: Big Blind (big blind) showed
Seat 4: UTG showed
Seat 5: Hero showed
Seat 6: UTGplus2 showed



PokerStars Zoom Hand #3434347943: Hold'em No Limit ($0.02/$0.05) - 2017/03/08 23:20:14
Table '#952' 6-max Seat #4 is the button
Seat 1: UTG ($4.74 in chips)
Seat 2: Hero ($7.51 in chips)
Seat 3: UTGplus2 ($9.58 in chips)
Seat 4: Dealer ($7.49 in chips)
Seat 5: Small Blind ($7.18 in chips)
Seat 6: Big Blind ($6.85 in chips)
Small Blind: posts small blind $0.02
Big Blind: posts big blind $0.05
*** HOLE CARDS ***
Dealt to Hero [Jc 3d]
UTG: folds
Hero: folds
UTGplus2: raises $0.15 to $0.15
Dealer: folds
Small Blind: folds
Big Blind: folds
Uncalled bet ($0.10) returned to UTGplus2
UTGplus2: doesn't show hand
UTGplus2 collected $0.12 from pot
*** SUMMARY ***
Total pot $0.12 | Rake $0.00
Seat 1: UTG showed
Seat 2: Hero showed
Seat 3: UTGplus2 won ($0.12)
Seat 4: Dealer (button) showed
Seat 5: Small Blind (small blind) showed
Seat 6: Big Blind (big blind) showed



PokerStars Zoom Hand #3434348011: Hold'em No Limit ($0.02/$0.05) - 2017/03/08 23:20:23
Table '#952' 6-max Seat #5 is the button
Seat 1: Big Blind ($3.72 in chips)
Seat 2: Hero ($7.51 in chips)
Seat 3: UTGplus1 ($5.20 in chips)
Seat 4: UTGplus2 ($5 in chips)
Seat 5: Dealer ($4.91 in chips)
Seat 6: Small Blind ($5.76 in chips)
Small Blind: posts small blind $0.02
Big Blind: posts big blind $0.05
*** HOLE CARDS ***
Dealt to Hero [9d Kc]
Hero: folds
UTGplus1: folds
UTGplus2: folds
Dealer: folds
Small Blind: folds
Big Blind: doesn't show hand
Big Blind collected $0.07 from pot
*** SUMMARY ***
Total pot $0.07 | Rake $0.00
Seat 1: Big Blind (big blind) won ($0.07)
Seat 2: Hero showed
Seat 3: UTGplus1 showed
Seat 4: UTGplus2 showed
Seat 5: Dealer (button) showed
Seat 6: Small Blind (small blind) showed



PokerStars Zoom Hand #3434348056: Hold'em No Limit ($0.02/$0.05) - 2017/03/08 23:20:29
Table '#952' 6-max Seat #6 is the button
Seat 1: Small Blind ($4.18 in chips)
Seat 2: Hero ($7.51 in chips)
Seat 3: UTG ($3.46 in chips)
Seat 4: UTGplus1 ($4.31 in chips)
Seat 5: UTGplus2 ($9.77 in chips)
Seat 6: Dealer ($7.08 in chips)
Small Blind: posts small blind $0.02
Hero: posts big blind $0.05
*** HOLE CARDS ***
Dealt to Hero [Tc 5c]
UTG: folds
UTGplus1: raises $0.15 to $0.15
UTGplus2: folds
Dealer: folds
Small Blind: calls $0.13 
Hero: folds
*** FLOP *** [Qs Th 8s]
Small Blind: checks
UTGplus1: bets $0.17 
Small Blind: raises $0.34 to $0.34
UTGplus1: folds
Uncalled bet ($0.17) returned to Small Blind
Small Blind: doesn't show hand
Small Blind collected $0.66 from pot
Table leave user
Seat re-join
*** SUMMARY ***
Total pot $0.69 | Rake $0.03
Board [Qs Th 8s]
Seat 1: Small Blind (small blind) won ($0.66)
Seat 2: Hero (big blind) showed
Seat 3: UTG showed
Seat 4: UTGplus1 showed
Seat 5: UTGplus2 showed
Seat 6: Dealer (button) showed



PokerStars Zoom Hand #3434348168: Hold'em No Limit ($0.02/$0.05) - 2017/03/08 23:20:43
Table '#952' 6-max Seat #1 is the button
Seat 1: Dealer ($5.20 in chips)
Seat 2: Small Blind ($4.74 in chips)
Seat 3: Big Blind ($4.85 in chips)
Seat 4: UTG ($5.04 in chips)
Seat 5: Hero ($7.46 in chips)
Seat 6: UTGplus2 ($6.24 in chips)
Small Blind: posts small blind $0.02
Big Blind: posts big blind $0.05
*** HOLE CARDS ***
Dealt to Hero [8c 9h]
UTG: folds
Hero: raises $0.17 to $0.17
UTGplus2: folds 
UTGplus2: Seat re-join
Dealer: calls $0.17 
Small Blind: folds
Big Blind: calls $0.12 
*** FLOP *** [7c 5h 8d]
Big Blind: checks
Hero: bets $0.43 
Dealer: folds
Big Blind: folds
Uncalled bet ($0.43) returned to Hero
Hero: doesn't show hand
Hero collected $0.51 from pot
Table deposit $2.50 
*** SUMMARY ***
Total pot $0.53 | Rake $0.02
Board [7c 5h 8d]
Seat 1: Dealer (button) showed
Seat 2: Small Blind (small blind) showed
Seat 3: Big Blind (big blind) showed
Seat 4: UTG showed
Seat 5: Hero won ($0.51)
Seat 6: UTGplus2 showed



PokerStars Zoom Hand #3434348643: Hold'em No Limit ($0.02/$0.05) - 2017/03/08 23:21:42
Table '#952' 6-max Seat #4 is the button
Seat 1: UTG ($3.43 in chips)
Seat 2: Hero ($7.80 in chips)
Seat 3: UTGplus2 ($6.67 in chips)
Seat 4: Dealer ($1.49 in chips)
Seat 5: Small Blind ($10.49 in chips)
Seat 6: Big Blind ($4.44 in chips)
Small Blind: posts small blind $0.02
Big Blind: posts big blind $0.05
*** HOLE CARDS ***
Dealt to Hero [3h 4h]
UTG: folds
Hero: folds
UTGplus2: raises $0.15 to $0.15
Dealer: folds 
Small Blind: folds
Dealer: Seat re-join
Big Blind: calls $0.10 
*** FLOP *** [9h 8c 8d]
Big Blind: checks
UTGplus2: bets $0.16 
Big Blind: folds
Uncalled bet ($0.16) returned to UTGplus2
UTGplus2: doesn't show hand
UTGplus2 collected $0.31 from pot
*** SUMMARY ***
Total pot $0.32 | Rake $0.01
Board [9h 8c 8d]
Seat 1: UTG showed
Seat 2: Hero showed
Seat 3: UTGplus2 won ($0.31)
Seat 4: Dealer (button) showed
Seat 5: Small Blind (small blind) showed
Seat 6: Big Blind (big blind) showed



PokerStars Zoom Hand #3434348717: Hold'em No Limit ($0.02/$0.05) - 2017/03/08 23:21:51
Table '#952' 6-max Seat #2 is the button
Seat 1: UTGplus2 ($2.09 in chips)
Seat 2: Hero ($7.80 in chips)
Seat 3: Small Blind ($5.03 in chips)
Seat 4: Big Blind ($3.06 in chips)
Seat 5: UTG ($7.22 in chips)
Seat 6: UTGplus1 ($5.85 in chips)
Small Blind: posts small blind $0.02
Big Blind: posts big blind $0.05
*** HOLE CARDS ***
Dealt to Hero [4c 8c]
UTG: raises $0.15 to $0.15
UTGplus1: folds
UTGplus2: folds
Hero: folds
Small Blind: folds
Big Blind: folds
Uncalled bet ($0.10) returned to UTG
UTG: doesn't show hand
UTG collected $0.12 from pot
*** SUMMARY ***
Total pot $0.12 | Rake $0.00
Seat 1: UTGplus2 showed
Seat 2: Hero (button) showed
Seat 3: Small Blind (small blind) showed
Seat 4: Big Blind (big blind) showed
Seat 5: UTG won ($0.12)
Seat 6: UTGplus1 showed



PokerStars Zoom Hand #3434348791: Hold'em No Limit ($0.02/$0.05) - 2017/03/08 23:22:02
Table '#952' 6-max Seat #2 is the button
Seat 1: Hero ($7.80 in chips)
Seat 2: Dealer ($2.45 in chips)
Seat 3: Small Blind ($8.23 in chips)
Seat 4: Big Blind ($3.72 in chips)
Seat 5: UTG ($2.05 in chips)
Seat 6: UTGplus1 ($7.76 in chips)
Small Blind: posts small blind $0.02
Big Blind: posts big blind $0.05
*** HOLE CARDS ***
Dealt to Hero [3h 7s]
UTG: folds
UTGplus1: folds
Hero: folds
Dealer: raises $0.15 to $0.15
Small Blind: folds
Big Blind: calls $0.10 
*** FLOP *** [Jd Tc Qd]
Big Blind: checks
Dealer: checks
*** TURN *** [Jd Tc Qd] [Ks]
Big Blind: checks
Dealer: bets $0.26 
Big Blind: calls $0.26 
*** RIVER *** [Jd Tc Qd Ks] [5c]
Big Blind: checks
Dealer: bets $0.79 
Big Blind: calls $0.79 
*** SHOW DOWN ***
Dealer: shows [7h Ah] (a straight, Ten to Ace)
Big Blind: shows [6h Kd] (One pair)
Dealer collected $2.3 from pot
Seat re-join
*** SUMMARY ***
Total pot $2.42 | Rake $0.12
Board [Jd Tc Qd Ks 5c]
Seat 1: Hero showed
Seat 2: Dealer (button) showed [7h Ah] and won ($2.3) with a straight, Ten to Ace
Seat 3: Small Blind (small blind) showed
Seat 4: Big Blind (big blind) showed [6h Kd]
Seat 5: UTG showed
Seat 6: UTGplus1 showed



PokerStars Zoom Hand #3434348867: Hold'em No Limit ($0.02/$0.05) - 2017/03/08 23:22:10
Table '#952' 6-max Seat #1 is the button
Seat 1: Dealer ($3.58 in chips)
Seat 2: Small Blind ($7.46 in chips)
Seat 3: Big Blind ($5.15 in chips)
Seat 4: Hero ($7.80 in chips)
Seat 5: UTGplus1 ($4.74 in chips)
Seat 6: UTGplus2 ($5.41 in chips)
Small Blind: posts small blind $0.02
Big Blind: posts big blind $0.05
*** HOLE CARDS ***
Dealt to Hero [Qc 8d]
Hero: folds
UTGplus1: folds
UTGplus2: raises $0.15 to $0.15
Dealer: calls $0.15 
Small Blind: folds
Big Blind: folds
*** FLOP *** [3s 7s 9c]
UTGplus2: bets $0.18 
Dealer: folds
Uncalled bet ($0.18) returned to UTGplus2
UTGplus2: doesn't show hand
UTGplus2 collected $0.36 from pot
*** SUMMARY ***
Total pot $0.37 | Rake $0.01
Board [3s 7s 9c]
Seat 1: Dealer (button) showed
Seat 2: Small Blind (small blind) showed
Seat 3: Big Blind (big blind) showed
Seat 4: Hero showed
Seat 5: UTGplus1 showed
Seat 6: UTGplus2 won ($0.36)



PokerStars Zoom Hand #3434348899: Hold'em No Limit ($0.02/$0.05) - 2017/03/08 23:22:15
Table '#952' 6-max Seat #1 is the button
Seat 1: Dealer ($4.74 in chips)
Seat 2: Small Blind ($7.76 in chips)
Seat 3: Big Blind ($8.21 in chips)
Seat 4: UTG ($21.13 in chips)
Seat 5: Hero ($7.80 in chips)
Seat 6: UTGplus2 ($8.40 in chips)
Small Blind: posts small blind $0.02
Big Blind: posts big blind $0.05
*** HOLE CARDS ***
Dealt to Hero [9d Ts]
UTG: calls $0.05 
Hero: calls $0.05 
UTGplus2: folds
Dealer: calls $0.05 
Small Blind: folds
Big Blind: checks
*** FLOP *** [3d 6h 8d]
Big Blind: checks
UTG: checks
Hero: checks
Dealer: checks
*** TURN *** [3d 6h 8d] [Qs]
Big Blind: checks
UTG: checks
Hero: checks
Dealer: checks
*** RIVER *** [3d 6h 8d Qs] [Jh]
Big Blind: checks
UTG: checks
Hero: bets $0.22 
Dealer: folds
Big Blind: folds
UTG: folds
Uncalled bet ($0.22) returned to Hero
Hero: doesn't show hand
Hero collected $0.21 from pot
*** SUMMARY ***
Total pot $0.22 | Rake $0.01
Board [3d 6h 8d Qs Jh]
Seat 1: Dealer (button) showed
Seat 2: Small Blind (small blind) showed
Seat 3: Big Blind (big blind) showed
Seat 4: UTG showed
Seat 5: Hero won ($0.21)
Seat 6: UTGplus2 showed



PokerStars Zoom Hand #3434349431: Hold'em No Limit ($0.02/$0.05) - 2017/03/08 23:23:27
Table '#952' 6-max Seat #6 is the button
Seat 1: Small Blind ($3.15 in chips)
Seat 2: Hero ($7.96 in chips)
Seat 3: UTG ($7.72 in chips)
Seat 4: UTGplus1 ($8.42 in chips)
Seat 5: UTGplus2 ($6.26 in chips)
Seat 6: Dealer ($8.16 in chips)
Small Blind: posts small blind $0.02
Hero: posts big blind $0.05
*** HOLE CARDS ***
Dealt to Hero [3h 9d]
UTG: folds
UTGplus1: folds
UTGplus2: folds
Dealer: folds
Small Blind: folds
Hero: doesn't show hand
Hero collected $0.07 from pot
*** SUMMARY ***
Total pot $0.07 | Rake $0.00
Seat 1: Small Blind (small blind) showed
Seat 2: Hero (big blind) won ($0.07)
Seat 3: UTG showed
Seat 4: UTGplus1 showed
Seat 5: UTGplus2 showed
Seat 6: Dealer (button) showed



PokerStars Zoom Hand #3434349531: Hold'em No Limit ($0.02/$0.05) - 2017/03/08 23:23:40
Table '#952' 6-max Seat #2 is the button
Seat 1: UTGplus2 ($6.21 in chips)
Seat 2: Hero ($7.98 in chips)
Seat 3: Small Blind ($12.91 in chips)
Seat 4: Big Blind ($3.69 in chips)
Seat 5: UTG ($2.45 in chips)
Seat 6: UTGplus1 ($2.52 in chips)
Small Blind: posts small blind $0.02
Big Blind: posts big blind $0.05
*** HOLE CARDS ***
Dealt to Hero [3s Jh]
UTG: folds
UTGplus1: folds
UTGplus2: folds
Hero: folds
Small Blind: folds
*** SHOW DOWN ***
Big Blind: shows [3c Qs] (high card Three)
Big Blind collected $0.07 from pot
*** SUMMARY ***
Total pot $0.07 | Rake $0.00
Seat 1: UTGplus2 showed
Seat 2: Hero (button) showed
Seat 3: Small Blind (small blind) showed
Seat 4: Big Blind (big blind) collected $0.02
Seat 5: UTG showed
Seat 6: UTGplus1 showed



PokerStars Zoom Hand #3434349619: Hold'em No Limit ($0.02/$0.05) - 2017/03/08 23:23:51
Table '#952' 6-max Seat #5 is the button
Seat 1: Big Blind ($8.47 in chips)
Seat 2: UTG ($15.95 in chips)
Seat 3: UTGplus1 ($5.36 in chips)
Seat 4: UTGplus2 ($21.19 in chips)
Seat 5: Hero ($7.98 in chips)
Seat 6: Small Blind ($3.31 in chips)
Small Blind: posts small blind $0.02
Big Blind: posts big blind $0.05
*** HOLE CARDS ***
Dealt to Hero [3d Jh]
UTG: folds
UTGplus1: folds
UTGplus2: folds
Hero: folds
Small Blind: folds
Big Blind: doesn't show hand
Big Blind collected $0.07 from pot
*** SUMMARY ***
Total pot $0.07 | Rake $0.00
Seat 1: Big Blind (big blind) won ($0.07)
Seat 2: UTG showed
Seat 3: UTGplus1 showed
Seat 4: UTGplus2 showed
Seat 5: Hero (button) showed
Seat 6: Small Blind (small blind) showed



PokerStars Zoom Hand #3434349656: Hold'em No Limit ($0.02/$0.05) - 2017/03/08 23:23:56
Table '#952' 6-max Seat #6 is the button
Seat 1: Small Blind ($21.19 in chips)
Seat 2: Big Blind ($5.61 in chips)
Seat 3: Hero ($7.98 in chips)
Seat 4: UTGplus1 ($15.95 in chips)
Seat 5: UTGplus2 ($3.60 in chips)
Seat 6: Dealer ($1.86 in chips)
Small Blind: posts small blind $0.02
Big Blind: posts big blind $0.05
*** HOLE CARDS ***
Dealt to Hero [3h 7c]
Hero: folds
UTGplus1: folds
UTGplus2: folds
Dealer: folds
Small Blind: folds
Big Blind: doesn't show hand
Big Blind collected $0.07 from pot
*** SUMMARY ***
Total pot $0.07 | Rake $0.00
Seat 1: Small Blind (small blind) showed
Seat 2: Big Blind (big blind) won ($0.07)
Seat 3: Hero showed
Seat 4: UTGplus1 showed
Seat 5: UTGplus2 showed
Seat 6: Dealer (button) showed



PokerStars Zoom Hand #3434349691: Hold'em No Limit ($0.02/$0.05) - 2017/03/08 23:24:01
Table '#952' 6-max Seat #1 is the button
Seat 1: Hero ($7.98 in chips)
Seat 2: Small Blind ($2.18 in chips)
Seat 3: Big Blind ($6.87 in chips)
Seat 4: UTG ($10.58 in chips)
Seat 5: UTGplus1 ($3.29 in chips)
Seat 6: UTGplus2 ($8.11 in chips)
Small Blind: posts small blind $0.02
Big Blind: posts big blind $0.05
*** HOLE CARDS ***
Dealt to Hero [Qh Td]
UTG: folds
UTGplus1: folds
UTGplus2: folds
Hero: raises $0.17 to $0.17
Small Blind: folds
Big Blind: calls $0.12 
*** FLOP *** [9d 8c Kc]
Big Blind: checks
Hero: bets $0.23 
Big Blind: folds 
Uncalled bet ($0.23) returned to Hero
Hero: doesn't show hand
Hero collected $0.35 from pot
*** SUMMARY ***
Total pot $0.36 | Rake $0.01
Board [9d 8c Kc]
Seat 1: Hero (button) won ($0.35)
Seat 2: Small Blind (small blind) showed
Seat 3: Big Blind (big blind) showed
Seat 4: UTG showed
Seat 5: UTGplus1 showed
Seat 6: UTGplus2 showed



PokerStars Zoom Hand #3434350099: Hold'em No Limit ($0.02/$0.05) - 2017/03/08 23:24:54
Table '#952' 6-max Seat #5 is the button
Seat 1: Big Blind ($2.09 in chips)
Seat 2: UTG ($7.48 in chips)
Seat 3: UTGplus1 ($7.20 in chips)
Seat 4: UTGplus2 ($7.29 in chips)
Seat 5: Dealer ($14.98 in chips)
Seat 6: Hero ($8.16 in chips)
Hero: posts small blind $0.02
Big Blind: posts big blind $0.05
*** HOLE CARDS ***
Dealt to Hero [5h Jc]
UTG: folds
UTGplus1: folds
UTGplus2: folds
Dealer: raises $0.15 to $0.15
Hero: folds
Big Blind: calls $0.10 
*** FLOP *** [8h Kh Qs]
Big Blind: checks
Dealer: bets $0.16 
Big Blind: calls $0.16 
*** TURN *** [8h Kh Qs] [Tc]
Big Blind: checks
Dealer: bets $0.42 
Big Blind: calls $0.42 
*** RIVER *** [8h Kh Qs Tc] [Ks]
Big Blind: checks
Dealer: bets $1.38 
Big Blind: folds
Uncalled bet ($1.38) returned to Dealer
Dealer: doesn't show hand
Dealer collected $1.41 from pot
*** SUMMARY ***
Total pot $1.48 | Rake $0.07
Board [8h Kh Qs Tc Ks]
Seat 1: Big Blind (big blind) showed
Seat 2: UTG showed
Seat 3: UTGplus1 showed
Seat 4: UTGplus2 showed
Seat 5: Dealer (button) won ($1.41)
Seat 6: Hero (small blind) showed



PokerStars Zoom Hand #3434350162: Hold'em No Limit ($0.02/$0.05) - 2017/03/08 23:25:02
Table '#952' 6-max Seat #1 is the button
Seat 1: Dealer ($7.38 in chips)
Seat 2: Small Blind ($5.71 in chips)
Seat 3: Big Blind ($21.85 in chips)
Seat 4: Hero ($8.14 in chips)
Seat 5: UTGplus1 ($5.39 in chips)
Seat 6: UTGplus2 ($3.49 in chips)
Small Blind: posts small blind $0.02
Big Blind: posts big blind $0.05
*** HOLE CARDS ***
Dealt to Hero [Qs 4d]
Hero: folds
UTGplus1: folds
UTGplus2: raises $0.17 to $0.17
Dealer: folds
Small Blind: folds
Big Blind: calls $0.12 
*** FLOP *** [6h 5c 3c]
Big Blind: checks
UTGplus2: bets $0.18 
Big Blind: calls $0.18 
*** TURN *** [6h 5c 3c] [8h]
Big Blind: checks
UTGplus2: bets $0.31 
Big Blind: calls $0.31 
*** RIVER *** [6h 5c 3c 8h] [8c]
Big Blind: checks
UTGplus2: bets $2.83 and is all-in
Big Blind: folds
Uncalled bet ($2.83) returned to UTGplus2
UTGplus2: doesn't show hand
UTGplus2 collected $1.28 from pot
*** SUMMARY ***
Total pot $1.34 | Rake $0.06
Board [6h 5c 3c 8h 8c]
Seat 1: Dealer (button) showed
Seat 2: Small Blind (small blind) showed
Seat 3: Big Blind (big blind) showed
Seat 4: Hero showed
Seat 5: UTGplus1 showed
Seat 6: UTGplus2 won ($1.28)



PokerStars Zoom Hand #3434350196: Hold'em No Limit ($0.02/$0.05) - 2017/03/08 23:25:07
Table '#952' 6-max Seat #5 is the button
Seat 1: Hero ($8.14 in chips)
Seat 2: UTG ($4.95 in chips)
Seat 3: UTGplus1 ($3.48 in chips)
Seat 4: UTGplus2 ($7.18 in chips)
Seat 5: Dealer ($3.64 in chips)
Seat 6: Small Blind ($4.96 in chips)
Small Blind: posts small blind $0.02
Hero: posts big blind $0.05
*** HOLE CARDS ***
Dealt to Hero [Ad 6s]
UTG: folds
UTGplus1: folds
UTGplus2: folds
Dealer: raises $0.15 to $0.15
Small Blind: folds
Hero: folds
Uncalled bet ($0.10) returned to Dealer
Dealer: doesn't show hand
Dealer collected $0.12 from pot
*** SUMMARY ***
Total pot $0.12 | Rake $0.00
Seat 1: Hero (big blind) showed
Seat 2: UTG showed
Seat 3: UTGplus1 showed
Seat 4: UTGplus2 showed
Seat 5: Dealer (button) won ($0.12)
Seat 6: Small Blind (small blind) showed



PokerStars Zoom Hand #3434350340: Hold'em No Limit ($0.02/$0.05) - 2017/03/08 23:25:25
Table '#952' 6-max Seat #3 is the button
Seat 1: Hero ($8.09 in chips)
Seat 2: UTGplus2 ($7.47 in chips)
Seat 3: Dealer ($4.95 in chips)
Seat 4: Small Blind ($12.04 in chips)
Seat 5: Big Blind ($3.19 in chips)
Seat 6: UTG ($8.84 in chips)
Small Blind: posts small blind $0.02
Big Blind: posts big blind $0.05
*** HOLE CARDS ***
Dealt to Hero [9d Qs]
UTG: folds
Hero: folds
UTGplus2: folds
Dealer: folds
Small Blind: raises $0.13 to $0.15
Big Blind: calls $0.10 
*** FLOP *** [7s Ad 4h]
Small Blind: bets $0.15 
Big Blind: folds
Uncalled bet ($0.15) returned to Small Blind
Small Blind: doesn't show hand
Small Blind collected $0.29 from pot
Table deposit $2.50 
*** SUMMARY ***
Total pot $0.3 | Rake $0.01
Board [7s Ad 4h]
Seat 1: Hero showed
Seat 2: UTGplus2 showed
Seat 3: Dealer (button) showed
Seat 4: Small Blind (small blind) won ($0.29)
Seat 5: Big Blind (big blind) showed
Seat 6: UTG showed



PokerStars Zoom Hand #3434350411: Hold'em No Limit ($0.02/$0.05) - 2017/03/08 23:25:34
Table '#952' 6-max Seat #4 is the button
Seat 1: Hero ($8.09 in chips)
Seat 2: UTGplus1 ($16.84 in chips)
Seat 3: UTGplus2 ($2.45 in chips)
Seat 4: Dealer ($7.39 in chips)
Seat 5: Small Blind ($5.27 in chips)
Seat 6: Big Blind ($7.42 in chips)
Small Blind: posts small blind $0.02
Big Blind: posts big blind $0.05
*** HOLE CARDS ***
Dealt to Hero [6c Qc]
Hero: folds
UTGplus1: raises $0.10 to $0.10
UTGplus2: folds
Dealer: calls $0.10 
Small Blind: folds
Big Blind: calls $0.05 
*** FLOP *** [Tc 5s 2d]
Big Blind: checks
UTGplus1: bets $0.15 
Dealer: calls $0.15 
Big Blind: calls $0.15 
*** TURN *** [Tc 5s 2d] [8c]
Big Blind: checks
UTGplus1: checks
Dealer: bets $0.26 
Big Blind: calls $0.26 
UTGplus1: calls $0.26 
*** RIVER *** [Tc 5s 2d 8c] [3d]
Big Blind: checks
UTGplus1: checks
Dealer: checks
*** SHOW DOWN ***
Big Blind: shows [Ac 4c] (a straight, Ace to Five)
UTGplus1: shows [Jd 7h] (high card Jack)
Dealer: shows [Qs Ts] (One pair)
Big Blind collected $1.48 from pot
*** SUMMARY ***
Total pot $1.55 | Rake $0.07
Board [Tc 5s 2d 8c 3d]
Seat 1: Hero showed
Seat 2: UTGplus1 showed [Jd 7h-Jd Tc 8c 7h 5s] and lost with high card Jack
Seat 3: UTGplus2 showed
Seat 4: Dealer (button) showed [Qs Ts]
Seat 5: Small Blind (small blind) showed
Seat 6: Big Blind (big blind) showed [Ac 4c] and won ($1.48) with a straight, Five to Jack



PokerStars Zoom Hand #3434350456: Hold'em No Limit ($0.02/$0.05) - 2017/03/08 23:25:40
Table '#952' 6-max Seat #4 is the button
Seat 1: UTG ($2.45 in chips)
Seat 2: UTGplus1 ($5.11 in chips)
Seat 3: UTGplus2 ($3.81 in chips)
Seat 4: Hero ($8.09 in chips)
Seat 5: Small Blind ($4.76 in chips)
Seat 6: Big Blind ($2.75 in chips)
Small Blind: posts small blind $0.02
Big Blind: posts big blind $0.05
*** HOLE CARDS ***
Dealt to Hero [Tc Ac]
UTG: folds
UTGplus1: folds
UTGplus2: raises $0.15 to $0.15
Hero: calls $0.15 
Small Blind: folds
Big Blind: raises $0.20 to $0.25
UTGplus2: calls $0.10 
Hero: calls $0.10 
*** FLOP *** [Ks 2d 2h]
Big Blind: bets $0.05 
UTGplus2: calls $0.05 
Hero: calls $0.05 
*** TURN *** [Ks 2d 2h] [Kd]
Big Blind: bets $0.05 
UTGplus2: calls $0.05 
Hero: calls $0.05 
*** RIVER *** [Ks 2d 2h Kd] [4d]
Big Blind: bets $0.05 
UTGplus2: folds
Hero: calls $0.05 
*** SHOW DOWN ***
Big Blind: shows [Ad Qh] (two pair, Kings and Aces)
Hero: shows [Tc Ac] (two pair, Kings and Aces)
Hero collected $0.56 from pot
Big Blind collected $0.56 from pot
*** SUMMARY ***
Total pot $1.17 | Rake $0.05
Board [Ks 2d 2h Kd 4d]
Seat 1: UTG showed
Seat 2: UTGplus1 showed
Seat 3: UTGplus2 showed
Seat 4: Hero (button) showed [Tc Ac] and won ($0.56) with two pair, Kings and Aces
Seat 5: Small Blind (small blind) showed
Seat 6: Big Blind (big blind) showed [Ad Qh] and won ($0.56) with two pair, Kings and Aces



PokerStars Zoom Hand #3434351057: Hold'em No Limit ($0.02/$0.05) - 2017/03/08 23:26:58
Table '#952' 6-max Seat #3 is the button
Seat 1: UTGplus1 ($2.50 in chips)
Seat 2: UTGplus2 ($3.51 in chips)
Seat 3: Dealer ($1.40 in chips)
Seat 4: Small Blind ($4.95 in chips)
Seat 5: Hero ($8.25 in chips)
Seat 6: UTG ($2.91 in chips)
Small Blind: posts small blind $0.02
Hero: posts big blind $0.05
*** HOLE CARDS ***
Dealt to Hero [2h Qs]
UTG: calls $0.05 
UTGplus1: folds
UTGplus2: folds
Dealer: raises $0.15 to $0.15
Small Blind: folds
Hero: folds
UTG: calls $0.10 
*** FLOP *** [Jc 9s 2d]
UTG: checks
Dealer: checks
*** TURN *** [Jc 9s 2d] [4c]
UTG: checks
Dealer: bets $0.18 
UTG: calls $0.18 
*** RIVER *** [Jc 9s 2d 4c] [Kd]
UTG: checks
Dealer: checks
*** SHOW DOWN ***
UTG: shows [Ah 6d] (high card Ace)
Dealer: shows [3h Ac] (High Card)
UTG collected $0.7 from pot
*** SUMMARY ***
Total pot $0.73 | Rake $0.03
Board [Jc 9s 2d 4c Kd]
Seat 1: UTGplus1 showed
Seat 2: UTGplus2 showed
Seat 3: Dealer (button) showed [3h Ac]
Seat 4: Small Blind (small blind) showed
Seat 5: Hero (big blind) showed
Seat 6: UTG showed [Ah 6d] and won ($0.7) with high card Ace



PokerStars Zoom Hand #3434351110: Hold'em No Limit ($0.02/$0.05) - 2017/03/08 23:27:06
Table '#952' 6-max Seat #2 is the button
Seat 1: UTGplus2 ($9.14 in chips)
Seat 2: Dealer ($5.32 in chips)
Seat 3: Small Blind ($3.76 in chips)
Seat 4: Big Blind ($16.66 in chips)
Seat 5: Hero ($8.20 in chips)
Seat 6: UTGplus1 ($21.92 in chips)
Small Blind: posts small blind $0.02
Big Blind: posts big blind $0.05
*** HOLE CARDS ***
Dealt to Hero [3c 9c]
Hero: folds
UTGplus1: calls $0.05 
UTGplus2: raises $0.25 to $0.25
Dealer: folds
Small Blind: folds
Big Blind: calls $0.20 
UTGplus1: calls $0.20 
*** FLOP *** [Qc Ac Th]
Big Blind: checks
UTGplus1: checks
UTGplus2: bets $0.38 
Big Blind: calls $0.38 
UTGplus1: calls $0.38 
*** TURN *** [Qc Ac Th] [8s]
Big Blind: checks
UTGplus1: bets $1.91 
UTGplus2: folds
Big Blind: calls $1.91 
*** RIVER *** [Qc Ac Th 8s] [7d]
Big Blind: checks
UTGplus1: checks
*** SHOW DOWN ***
Big Blind: shows [Ad 9s] (a pair of Aces)
UTGplus1: shows [Jd 9d] (a straight, Eight to Queen)
UTGplus1 collected $5.45 from pot
*** SUMMARY ***
Total pot $5.73 | Rake $0.28
Board [Qc Ac Th 8s 7d]
Seat 1: UTGplus2 showed
Seat 2: Dealer (button) showed
Seat 3: Small Blind (small blind) showed
Seat 4: Big Blind (big blind) showed [Ad 9s] and lost with a pair of Aces
Seat 5: Hero showed
Seat 6: UTGplus1 showed [Jd 9d] and won ($5.45) with a straight, Eight to Queen



PokerStars Zoom Hand #3434351160: Hold'em No Limit ($0.02/$0.05) - 2017/03/08 23:27:11
Table '#952' 6-max Seat #1 is the button
Seat 1: Dealer ($3.74 in chips)
Seat 2: Hero ($8.20 in chips)
Seat 3: Big Blind ($8.47 in chips)
Seat 4: UTG ($5.84 in chips)
Seat 5: UTGplus1 ($3.59 in chips)
Seat 6: UTGplus2 ($4.11 in chips)
Hero: posts small blind $0.02
Big Blind: posts big blind $0.05
*** HOLE CARDS ***
Dealt to Hero [8h 6d]
UTG: folds
UTGplus1: folds
UTGplus2: folds
Dealer: folds
Hero: folds
Big Blind: doesn't show hand
Big Blind collected $0.07 from pot
*** SUMMARY ***
Total pot $0.07 | Rake $0.00
Seat 1: Dealer (button) showed
Seat 2: Hero (small blind) showed
Seat 3: Big Blind (big blind) won ($0.07)
Seat 4: UTG showed
Seat 5: UTGplus1 showed
Seat 6: UTGplus2 showed



PokerStars Zoom Hand #3434351214: Hold'em No Limit ($0.02/$0.05) - 2017/03/08 23:27:17
Table '#952' 6-max Seat #6 is the button
Seat 1: Small Blind ($4.56 in chips)
Seat 2: Big Blind ($3.59 in chips)
Seat 3: UTG ($12.94 in chips)
Seat 4: UTGplus1 ($8.55 in chips)
Seat 5: Hero ($8.18 in chips)
Seat 6: Dealer ($4.11 in chips)
Small Blind: posts small blind $0.02
Big Blind: posts big blind $0.05
*** HOLE CARDS ***
Dealt to Hero [3c 5c]
UTG: folds
UTGplus1: raises $0.15 to $0.15
Hero: folds
Dealer: folds
Small Blind: folds
Big Blind: calls $0.10 
*** FLOP *** [6d 6h 5h]
Big Blind: checks
UTGplus1: bets $0.21 
Big Blind: folds
Uncalled bet ($0.21) returned to UTGplus1
UTGplus1: doesn't show hand
UTGplus1 collected $0.31 from pot
*** SUMMARY ***
Total pot $0.32 | Rake $0.01
Board [6d 6h 5h]
Seat 1: Small Blind (small blind) showed
Seat 2: Big Blind (big blind) showed
Seat 3: UTG showed
Seat 4: UTGplus1 won ($0.31)
Seat 5: Hero showed
Seat 6: Dealer (button) showed



PokerStars Zoom Hand #3434351310: Hold'em No Limit ($0.02/$0.05) - 2017/03/08 23:27:29
Table '#952' 6-max Seat #1 is the button
Seat 1: Hero ($8.18 in chips)
Seat 2: Small Blind ($7.27 in chips)
Seat 3: Big Blind ($5.66 in chips)
Seat 4: UTG ($2.60 in chips)
Seat 5: UTGplus1 ($3.68 in chips)
Seat 6: UTGplus2 ($2.92 in chips)
Small Blind: posts small blind $0.02
Big Blind: posts big blind $0.05
*** HOLE CARDS ***
Dealt to Hero [Js Kd]
UTG: folds
UTGplus1: folds
UTGplus2: calls $0.05 
Hero: raises $0.22 to $0.22
Small Blind: folds
Big Blind: folds
UTGplus2: calls $0.17 
*** FLOP *** [Kc 8s Tc]
UTGplus2: checks
Hero: bets $0.41 
UTGplus2: folds
Uncalled bet ($0.41) returned to Hero
Hero: doesn't show hand
Hero collected $0.49 from pot
*** SUMMARY ***
Total pot $0.51 | Rake $0.02
Board [Kc 8s Tc]
Seat 1: Hero (button) won ($0.49)
Seat 2: Small Blind (small blind) showed
Seat 3: Big Blind (big blind) showed
Seat 4: UTG showed
Seat 5: UTGplus1 showed
Seat 6: UTGplus2 showed



PokerStars Zoom Hand #3434351688: Hold'em No Limit ($0.02/$0.05) - 2017/03/08 23:28:16
Table '#952' 6-max Seat #4 is the button
Seat 1: UTG ($5.54 in chips)
Seat 2: UTGplus1 ($4.89 in chips)
Seat 3: UTGplus2 ($1.62 in chips)
Seat 4: Dealer ($21.17 in chips)
Seat 5: Small Blind ($12.82 in chips)
Seat 6: Hero ($8.45 in chips)
Small Blind: posts small blind $0.02
Hero: posts big blind $0.05
*** HOLE CARDS ***
Dealt to Hero [5c Jh]
UTG: folds
UTGplus1: folds
UTGplus2: raises $0.15 to $0.15
Dealer: folds
Small Blind: folds
Hero: folds
Uncalled bet ($0.10) returned to UTGplus2
UTGplus2: doesn't show hand
UTGplus2 collected $0.12 from pot
*** SUMMARY ***
Total pot $0.12 | Rake $0.00
Seat 1: UTG showed
Seat 2: UTGplus1 showed
Seat 3: UTGplus2 won ($0.12)
Seat 4: Dealer (button) showed
Seat 5: Small Blind (small blind) showed
Seat 6: Hero (big blind) showed



PokerStars Zoom Hand #3434351800: Hold'em No Limit ($0.02/$0.05) - 2017/03/08 23:28:29
Table '#952' 6-max Seat #6 is the button
Seat 1: Small Blind ($5.34 in chips)
Seat 2: Big Blind ($1.53 in chips)
Seat 3: UTG ($4.95 in chips)
Seat 4: Hero ($8.40 in chips)
Seat 5: UTGplus2 ($9.09 in chips)
Seat 6: Dealer ($5.52 in chips)
Small Blind: posts small blind $0.02
Big Blind: posts big blind $0.05
*** HOLE CARDS ***
Dealt to Hero [9d 5c]
UTG: folds
Hero: folds
UTGplus2: raises $0.12 to $0.12
Dealer: folds
Small Blind: folds
Big Blind: folds
Uncalled bet ($0.07) returned to UTGplus2
UTGplus2: doesn't show hand
UTGplus2 collected $0.12 from pot
*** SUMMARY ***
Total pot $0.12 | Rake $0.00
Seat 1: Small Blind (small blind) showed
Seat 2: Big Blind (big blind) showed
Seat 3: UTG showed
Seat 4: Hero showed
Seat 5: UTGplus2 won ($0.12)
Seat 6: Dealer (button) showed



PokerStars Zoom Hand #3434351844: Hold'em No Limit ($0.02/$0.05) - 2017/03/08 23:28:35
Table '#952' 6-max Seat #3 is the button
Seat 1: Hero ($8.40 in chips)
Seat 2: UTGplus2 ($1.80 in chips)
Seat 3: Dealer ($5.77 in chips)
Seat 4: Small Blind ($6.95 in chips)
Seat 5: Big Blind ($5.08 in chips)
Seat 6: UTG ($6.30 in chips)
Small Blind: posts small blind $0.02
Big Blind: posts big blind $0.05
*** HOLE CARDS ***
Dealt to Hero [2d 3s]
UTG: raises $0.10 to $0.10
Hero: folds
UTGplus2: folds
Dealer: folds
Small Blind: folds
Big Blind: calls $0.05 
*** FLOP *** [5c 3c 9s]
Big Blind: checks
UTG: checks
*** TURN *** [5c 3c 9s] [6h]
Big Blind: checks
UTG: checks
*** RIVER *** [5c 3c 9s 6h] [9h]
Big Blind: checks
UTG: checks
*** SHOW DOWN ***
Big Blind: shows [Kd 5h] (two pair, Nines and Kings)
UTG: shows [Kh Ad] (One pair)
Big Blind collected $0.21 from pot
*** SUMMARY ***
Total pot $0.22 | Rake $0.01
Board [5c 3c 9s 6h 9h]
Seat 1: Hero showed
Seat 2: UTGplus2 showed
Seat 3: Dealer (button) showed
Seat 4: Small Blind (small blind) showed
Seat 5: Big Blind (big blind) showed [Kd 5h] and won ($0.21) with two pair, Nines and Kings
Seat 6: UTG showed [Kh Ad]



PokerStars Zoom Hand #3434351889: Hold'em No Limit ($0.02/$0.05) - 2017/03/08 23:28:40
Table '#952' 6-max Seat #3 is the button
Seat 1: UTGplus1 ($5.55 in chips)
Seat 2: UTGplus2 ($7.96 in chips)
Seat 3: Dealer ($2.25 in chips)
Seat 4: Small Blind ($1.80 in chips)
Seat 5: Big Blind ($6.34 in chips)
Seat 6: Hero ($8.40 in chips)
Small Blind: posts small blind $0.02
Big Blind: posts big blind $0.05
*** HOLE CARDS ***
Dealt to Hero [7h 9s]
Hero: folds
UTGplus1: folds
UTGplus2: folds
Dealer: folds
Small Blind: folds
Big Blind: doesn't show hand
Big Blind collected $0.07 from pot
*** SUMMARY ***
Total pot $0.07 | Rake $0.00
Seat 1: UTGplus1 showed
Seat 2: UTGplus2 showed
Seat 3: Dealer (button) showed
Seat 4: Small Blind (small blind) showed
Seat 5: Big Blind (big blind) won ($0.07)
Seat 6: Hero showed



PokerStars Zoom Hand #3434351939: Hold'em No Limit ($0.02/$0.05) - 2017/03/08 23:28:46
Table '#952' 6-max Seat #2 is the button
Seat 1: UTGplus2 ($7.61 in chips)
Seat 2: Hero ($8.40 in chips)
Seat 3: Small Blind ($8.56 in chips)
Seat 4: Big Blind ($3.51 in chips)
Seat 5: UTG ($5.55 in chips)
Seat 6: UTGplus1 ($5.67 in chips)
Small Blind: posts small blind $0.02
Big Blind: posts big blind $0.05
*** HOLE CARDS ***
Dealt to Hero [4c Ad]
UTG: folds
UTGplus1: raises $0.15 to $0.15
UTGplus2: folds
Hero: calls $0.15 
Small Blind: calls $0.13 
Big Blind: folds
*** FLOP *** [Kh As Ah]
Small Blind: checks 
UTGplus1: bets $0.35 
Hero: calls $0.35 
Small Blind: folds
*** TURN *** [Kh As Ah] [Qs]
UTGplus1: checks
Hero: bets $0.90 
UTGplus1: calls $0.90 
*** RIVER *** [Kh As Ah Qs] [5c]
UTGplus1: checks
Hero: bets $2.70 
UTGplus1: calls $2.70 
*** SHOW DOWN ***
Hero: shows [4c Ad] (three of a kind, Aces)
UTGplus1: shows [Tc Ac] (three of a kind, Aces)
Hero collected $3.99 from pot
UTGplus1 collected $3.99 from pot
*** SUMMARY ***
Total pot $8.4 | Rake $0.42
Board [Kh As Ah Qs 5c]
Seat 1: UTGplus2 showed
Seat 2: Hero (button) showed [4c Ad] and won ($3.99) with three of a kind, Aces
Seat 3: Small Blind (small blind) showed
Seat 4: Big Blind (big blind) showed
Seat 5: UTG showed
Seat 6: UTGplus1 showed [Tc Ac] and won ($3.99) with three of a kind, Aces



PokerStars Zoom Hand #3434352769: Hold'em No Limit ($0.02/$0.05) - 2017/03/08 23:30:31
Table '#952' 6-max Seat #5 is the button
Seat 1: Big Blind ($5.25 in chips)
Seat 2: Hero ($8.29 in chips)
Seat 3: UTGplus1 ($5.56 in chips)
Seat 4: UTGplus2 ($2.22 in chips)
Seat 5: Dealer ($7.61 in chips)
Seat 6: Small Blind ($1.46 in chips)
Small Blind: posts small blind $0.02
Big Blind: posts big blind $0.05
*** HOLE CARDS ***
Dealt to Hero [4h 3h]
Hero: folds
UTGplus1: folds
UTGplus2: folds
Dealer: calls $0.05 
Small Blind: folds
Big Blind: checks
*** FLOP *** [7d 6d 3s]
Big Blind: checks
Dealer: checks
*** TURN *** [7d 6d 3s] [4c]
Big Blind: bets $0.06 
Dealer: folds
Uncalled bet ($0.06) returned to Big Blind
Big Blind: doesn't show hand
Big Blind collected $0.12 from pot
*** SUMMARY ***
Total pot $0.12 | Rake $0.00
Board [7d 6d 3s 4c]
Seat 1: Big Blind (big blind) won ($0.12)
Seat 2: Hero showed
Seat 3: UTGplus1 showed
Seat 4: UTGplus2 showed
Seat 5: Dealer (button) showed
Seat 6: Small Blind (small blind) showed



PokerStars Zoom Hand #3434352836: Hold'em No Limit ($0.02/$0.05) - 2017/03/08 23:30:39
Table '#952' 6-max Seat #6 is the button
Seat 1: Small Blind ($2.92 in chips)
Seat 2: Hero ($8.29 in chips)
Seat 3: UTG ($21.82 in chips)
Seat 4: UTGplus1 ($2.35 in chips)
Seat 5: UTGplus2 ($4.42 in chips)
Seat 6: Dealer ($5.51 in chips)
Small Blind: posts small blind $0.02
Hero: posts big blind $0.05
*** HOLE CARDS ***
Dealt to Hero [8s 6h]
UTG: folds
UTGplus1: calls $0.05 
UTGplus2: raises $0.20 to $0.20
Dealer: folds
Small Blind: calls $0.18 
Hero: folds
UTGplus1: calls $0.15 
*** FLOP *** [Qs As 4d]
Small Blind: checks
UTGplus1: checks
UTGplus2: checks
*** TURN *** [Qs As 4d] [2h]
Small Blind: bets $0.52 
UTGplus1: folds
UTGplus2: folds
Uncalled bet ($0.52) returned to Small Blind
Small Blind: doesn't show hand
Small Blind collected $0.62 from pot
*** SUMMARY ***
Total pot $0.65 | Rake $0.03
Board [Qs As 4d 2h]
Seat 1: Small Blind (small blind) won ($0.62)
Seat 2: Hero (big blind) showed
Seat 3: UTG showed
Seat 4: UTGplus1 showed
Seat 5: UTGplus2 showed
Seat 6: Dealer (button) showed



PokerStars Zoom Hand #3434352877: Hold'em No Limit ($0.02/$0.05) - 2017/03/08 23:30:44
Table '#952' 6-max Seat #1 is the button
Seat 1: Hero ($8.24 in chips)
Seat 2: Small Blind ($21.82 in chips)
Seat 3: Big Blind ($4.78 in chips)
Seat 4: UTG ($5.70 in chips)
Seat 5: UTGplus1 ($1.14 in chips)
Seat 6: UTGplus2 ($4.95 in chips)
Small Blind: posts small blind $0.02
Big Blind: posts big blind $0.05
*** HOLE CARDS ***
Dealt to Hero [Tc 2s]
UTG: folds
UTGplus1: folds
UTGplus2: calls $0.05 
Hero: folds
Small Blind: folds
Big Blind: checks
*** FLOP *** [Qd Th 7d]
Big Blind: bets $0.05 
UTGplus2: calls $0.05 
*** TURN *** [Qd Th 7d] [2d]
Big Blind: bets $0.15 
UTGplus2: folds
Uncalled bet ($0.15) returned to Big Blind
Big Blind: doesn't show hand
Big Blind collected $0.21 from pot
*** SUMMARY ***
Total pot $0.22 | Rake $0.01
Board [Qd Th 7d 2d]
Seat 1: Hero (button) showed
Seat 2: Small Blind (small blind) showed
Seat 3: Big Blind (big blind) won ($0.21)
Seat 4: UTG showed
Seat 5: UTGplus1 showed
Seat 6: UTGplus2 showed



PokerStars Zoom Hand #3434352918: Hold'em No Limit ($0.02/$0.05) - 2017/03/08 23:30:49
Table '#952' 6-max Seat #3 is the button
Seat 1: UTGplus1 ($1.14 in chips)
Seat 2: UTGplus2 ($21.80 in chips)
Seat 3: Hero ($8.24 in chips)
Seat 4: Small Blind ($6.75 in chips)
Seat 5: Big Blind ($8.71 in chips)
Seat 6: UTG ($6.69 in chips)
Small Blind: posts small blind $0.02
Big Blind: posts big blind $0.05
*** HOLE CARDS ***
Dealt to Hero [Kh 6s]
UTG: folds
UTGplus1: folds
UTGplus2: raises $0.25 to $0.25
Hero: folds
Small Blind: folds
Big Blind: calls $0.20 
*** FLOP *** [8h 3d Th]
Big Blind: checks
UTGplus2: bets $0.35 
Big Blind: raises $0.95 to $0.95
UTGplus2: folds
Uncalled bet ($0.60) returned to Big Blind
Big Blind: doesn't show hand
Big Blind collected $1.16 from pot
*** SUMMARY ***
Total pot $1.22 | Rake $0.06
Board [8h 3d Th]
Seat 1: UTGplus1 showed
Seat 2: UTGplus2 showed
Seat 3: Hero (button) showed
Seat 4: Small Blind (small blind) showed
Seat 5: Big Blind (big blind) won ($1.16)
Seat 6: UTG showed



PokerStars Zoom Hand #3434352997: Hold'em No Limit ($0.02/$0.05) - 2017/03/08 23:31:00
Table '#952' 6-max Seat #5 is the button
Seat 1: Big Blind ($5 in chips)
Seat 2: UTG ($5.37 in chips)
Seat 3: UTGplus1 ($5.73 in chips)
Seat 4: Hero ($8.24 in chips)
Seat 5: Dealer ($5.98 in chips)
Seat 6: Small Blind ($5.46 in chips)
Small Blind: posts small blind $0.02
Big Blind: posts big blind $0.05
*** HOLE CARDS ***
Dealt to Hero [4h Ah]
UTG: folds
UTGplus1: folds
Hero: raises $0.17 to $0.17
Dealer: folds
Small Blind: folds
Big Blind: folds
Uncalled bet ($0.12) returned to Hero
Hero: doesn't show hand
Hero collected $0.12 from pot
*** SUMMARY ***
Total pot $0.12 | Rake $0.00
Seat 1: Big Blind (big blind) showed
Seat 2: UTG showed
Seat 3: UTGplus1 showed
Seat 4: Hero won ($0.12)
Seat 5: Dealer (button) showed
Seat 6: Small Blind (small blind) showed



PokerStars Zoom Hand #3434353135: Hold'em No Limit ($0.02/$0.05) - 2017/03/08 23:31:20
Table '#952' 6-max Seat #6 is the button
Seat 1: Small Blind ($1.39 in chips)
Seat 2: Big Blind ($7.03 in chips)
Seat 3: UTG ($4.85 in chips)
Seat 4: Hero ($8.31 in chips)
Seat 5: UTGplus2 ($4.95 in chips)
Seat 6: Dealer ($2.27 in chips)
Small Blind: posts small blind $0.02
Big Blind: posts big blind $0.05
*** HOLE CARDS ***
Dealt to Hero [8c Th]
UTG: calls $0.05 
Hero: folds
UTGplus2: folds
Dealer: folds
Small Blind: folds
Big Blind: checks
*** FLOP *** [9d Ks 6c]
Big Blind: checks
UTG: checks
*** TURN *** [9d Ks 6c] [Td]
Big Blind: checks
UTG: bets $0.05 
Big Blind: folds
Uncalled bet ($0.05) returned to UTG
UTG: doesn't show hand
UTG collected $0.12 from pot
Table leave user
*** SUMMARY ***
Total pot $0.12 | Rake $0.00
Board [9d Ks 6c Td]
Seat 1: Small Blind (small blind) showed
Seat 2: Big Blind (big blind) showed
Seat 3: UTG won ($0.12)
Seat 4: Hero showed
Seat 5: UTGplus2 showed
Seat 6: Dealer (button) showed



PokerStars Zoom Hand #3434353221: Hold'em No Limit ($0.02/$0.05) - 2017/03/08 23:31:31
Table '#952' 6-max Seat #1 is the button
Seat 1: Dealer ($17.12 in chips)
Seat 2: Hero ($8.31 in chips)
Seat 3: Big Blind ($8.85 in chips)
Seat 4: UTG ($4.28 in chips)
Seat 5: UTGplus1 ($4.85 in chips)
Seat 6: UTGplus2 ($9.06 in chips)
Hero: posts small blind $0.02
Big Blind: posts big blind $0.05
*** HOLE CARDS ***
Dealt to Hero [9s Jd]
UTG: calls $0.05 
UTGplus1: folds
UTGplus2: calls $0.05 
Dealer: raises $0.20 to $0.20
Hero: calls $0.18 
Big Blind: folds
UTG: calls $0.15 
UTGplus2: calls $0.15 
*** FLOP *** [2s Kh 6s]
Hero: checks
UTG: checks
UTGplus2: checks
Dealer: bets $0.85 
Hero: folds
UTG: folds
UTGplus2: calls $0.85 
*** TURN *** [2s Kh 6s] [Ah]
UTGplus2: checks
Dealer: checks
*** RIVER *** [2s Kh 6s Ah] [4c]
UTGplus2: bets $0.34 
Dealer: calls $0.34 
*** SHOW DOWN ***
UTGplus2: shows [Ts 3s] (high card Ace)
Dealer: shows [Kd 8h] (a pair of Kings)
Dealer collected $3.07 from pot
*** SUMMARY ***
Total pot $3.23 | Rake $0.16
Board [2s Kh 6s Ah 4c]
Seat 1: Dealer (button) showed [Kd 8h] and won ($3.07) with a pair of Kings
Seat 2: Hero (small blind) showed
Seat 3: Big Blind (big blind) showed
Seat 4: UTG showed
Seat 5: UTGplus1 showed
Seat 6: UTGplus2 showed [Ts 3s-Ah Kh Ts 6s 4c] and lost with high card Ten



PokerStars Zoom Hand #3434353708: Hold'em No Limit ($0.02/$0.05) - 2017/03/08 23:32:28
Table '#952' 6-max Seat #2 is the button
Seat 1: UTGplus2 ($3.51 in chips)
Seat 2: Dealer ($6.58 in chips)
Seat 3: Small Blind ($4.35 in chips)
Seat 4: Big Blind ($1.22 in chips)
Seat 5: UTG ($3.56 in chips)
Seat 6: Hero ($8.11 in chips)
Small Blind: posts small blind $0.02
Big Blind: posts big blind $0.05
*** HOLE CARDS ***
Dealt to Hero [7h 9s]
UTG: folds
Hero: folds
UTGplus2: folds
Dealer: folds
Small Blind: raises $0.13 to $0.15
Big Blind: folds
Uncalled bet ($0.10) returned to Small Blind
Small Blind: doesn't show hand
Small Blind collected $0.1 from pot
*** SUMMARY ***
Total pot $0.1 | Rake $0.00
Seat 1: UTGplus2 showed
Seat 2: Dealer (button) showed
Seat 3: Small Blind (small blind) won ($0.1)
Seat 4: Big Blind (big blind) showed
Seat 5: UTG showed
Seat 6: Hero showed



PokerStars Zoom Hand #3434353767: Hold'em No Limit ($0.02/$0.05) - 2017/03/08 23:32:33
Table '#952' 6-max Seat #2 is the button
Seat 1: UTGplus2 ($4.91 in chips)
Seat 2: Dealer ($5.43 in chips)
Seat 3: Small Blind ($18.85 in chips)
Seat 4: Big Blind ($5 in chips)
Seat 5: UTG ($5.12 in chips)
Seat 6: Hero ($8.11 in chips)
Small Blind: posts small blind $0.02
Big Blind: posts big blind $0.05
*** HOLE CARDS ***
Dealt to Hero [3h Jd]
UTG: raises $0.10 to $0.10
Hero: folds
UTGplus2: folds
Dealer: folds
Small Blind: raises $0.13 to $0.15
Big Blind: calls $0.10 
UTG: raises $0.10 to $0.20
Small Blind: calls $0.05 
Big Blind: calls $0.05 
*** FLOP *** [8c 9d 4h]
Small Blind: bets $0.05 
Big Blind: calls $0.05 
UTG: raises $0.10 to $0.10
Small Blind: calls $0.05 
Big Blind: calls $0.05 
*** TURN *** [8c 9d 4h] [6d]
Small Blind: bets $0.05 
Big Blind: calls $0.05 
UTG: raises $4.77 to $4.82 and is all-in
Small Blind: folds
Big Blind: folds
Uncalled bet ($4.77) returned to UTG
UTG: doesn't show hand
UTG collected $1 from pot
*** SUMMARY ***
Total pot $1.05 | Rake $0.05
Board [8c 9d 4h 6d]
Seat 1: UTGplus2 showed
Seat 2: Dealer (button) showed
Seat 3: Small Blind (small blind) showed
Seat 4: Big Blind (big blind) showed
Seat 5: UTG won ($1)
Seat 6: Hero showed



PokerStars Zoom Hand #3434353810: Hold'em No Limit ($0.02/$0.05) - 2017/03/08 23:32:39
Table '#952' 6-max Seat #6 is the button
Seat 1: Small Blind ($1.52 in chips)
Seat 2: Hero ($8.11 in chips)
Seat 3: UTG ($9.50 in chips)
Seat 4: UTGplus1 ($3.51 in chips)
Seat 5: UTGplus2 ($4.36 in chips)
Seat 6: Dealer ($4.33 in chips)
Small Blind: posts small blind $0.02
Hero: posts big blind $0.05
*** HOLE CARDS ***
Dealt to Hero [6c Jh]
UTG: folds
UTGplus1: raises $0.15 to $0.15
UTGplus2: calls $0.15 
Dealer: folds
Small Blind: calls $0.13 
Hero: folds
*** FLOP *** [Qd 8s 5s]
Small Blind: checks
UTGplus1: bets $0.30 
UTGplus2: raises $0.60 to $0.60
Small Blind: folds
UTGplus1: calls $0.30 
*** TURN *** [Qd 8s 5s] [8d]
UTGplus1: checks
UTGplus2: bets $3.61 and is all-in
UTGplus1: calls $2.76 and is all-in
*** RIVER *** [Qd 8s 5s 8d] [8h]
*** SHOW DOWN ***
UTGplus1: shows [Qc Td] (a full house, Eights full of Queens)
UTGplus2: shows [8c 5c] (four of a kind, Eights)
Uncalled bet ($0.85) returned to UTGplus2
UTGplus2 collected $6.86 from pot
*** SUMMARY ***
Total pot $7.22 | Rake $0.36
Board [Qd 8s 5s 8d 8h]
Seat 1: Small Blind (small blind) showed
Seat 2: Hero (big blind) showed
Seat 3: UTG showed
Seat 4: UTGplus1 showed [Qc Td] and lost with a full house, Eights full of Queens
Seat 5: UTGplus2 showed [8c 5c] and won ($6.86) with four of a kind, Eights
Seat 6: Dealer (button) showed



PokerStars Zoom Hand #3434353869: Hold'em No Limit ($0.02/$0.05) - 2017/03/08 23:32:46
Table '#952' 6-max Seat #1 is the button
Seat 1: Dealer ($7.98 in chips)
Seat 2: Small Blind ($3.19 in chips)
Seat 3: Big Blind ($5.24 in chips)
Seat 4: UTG ($1.17 in chips)
Seat 5: UTGplus1 ($2.69 in chips)
Seat 6: Hero ($8.06 in chips)
Small Blind: posts small blind $0.02
Big Blind: posts big blind $0.05
*** HOLE CARDS ***
Dealt to Hero [6h Ks]
UTG: folds
UTGplus1: folds
Hero: folds
Dealer: folds
Small Blind: raises $0.18 to $0.20
Big Blind: folds
Uncalled bet ($0.15) returned to Small Blind
Small Blind: doesn't show hand
Small Blind collected $0.1 from pot
*** SUMMARY ***
Total pot $0.1 | Rake $0.00
Seat 1: Dealer (button) showed
Seat 2: Small Blind (small blind) won ($0.1)
Seat 3: Big Blind (big blind) showed
Seat 4: UTG showed
Seat 5: UTGplus1 showed
Seat 6: Hero showed



PokerStars Zoom Hand #3434353937: Hold'em No Limit ($0.02/$0.05) - 2017/03/08 23:32:54
Table '#952' 6-max Seat #5 is the button
Seat 1: Big Blind ($3.68 in chips)
Seat 2: UTG ($11.90 in chips)
Seat 3: UTGplus1 ($14.46 in chips)
Seat 4: UTGplus2 ($1.43 in chips)
Seat 5: Dealer ($4.93 in chips)
Seat 6: Hero ($8.06 in chips)
Hero: posts small blind $0.02
Big Blind: posts big blind $0.05
*** HOLE CARDS ***
Dealt to Hero [Qd 6h]
UTG: folds
UTGplus1: folds
UTGplus2: calls $0.05 
Dealer: folds
Hero: folds
Big Blind: checks
*** FLOP *** [2c 2s 8s]
Big Blind: checks
UTGplus2: checks
*** TURN *** [2c 2s 8s] [Ks]
Big Blind: checks
UTGplus2: bets $0.12 
Big Blind: folds
Uncalled bet ($0.12) returned to UTGplus2
UTGplus2: doesn't show hand
UTGplus2 collected $0.12 from pot
*** SUMMARY ***
Total pot $0.12 | Rake $0.00
Board [2c 2s 8s Ks]
Seat 1: Big Blind (big blind) showed
Seat 2: UTG showed
Seat 3: UTGplus1 showed
Seat 4: UTGplus2 won ($0.12)
Seat 5: Dealer (button) showed
Seat 6: Hero (small blind) showed



PokerStars Zoom Hand #3434354071: Hold'em No Limit ($0.02/$0.05) - 2017/03/08 23:33:10
Table '#952' 6-max Seat #5 is the button
Seat 1: Big Blind ($3.50 in chips)
Seat 2: UTG ($9.52 in chips)
Seat 3: UTGplus1 ($2.84 in chips)
Seat 4: UTGplus2 ($9.43 in chips)
Seat 5: Dealer ($2.83 in chips)
Seat 6: Hero ($8.04 in chips)
Hero: posts small blind $0.02
Big Blind: posts big blind $0.05
*** HOLE CARDS ***
Dealt to Hero [2c Qs]
UTG: folds
UTGplus1: folds
UTGplus2: folds
Dealer: folds
Hero: folds
Big Blind: doesn't show hand
Big Blind collected $0.07 from pot
*** SUMMARY ***
Total pot $0.07 | Rake $0.00
Seat 1: Big Blind (big blind) won ($0.07)
Seat 2: UTG showed
Seat 3: UTGplus1 showed
Seat 4: UTGplus2 showed
Seat 5: Dealer (button) showed
Seat 6: Hero (small blind) showed



PokerStars Zoom Hand #3434354097: Hold'em No Limit ($0.02/$0.05) - 2017/03/08 23:33:14
Table '#952' 6-max Seat #6 is the button
Seat 1: Small Blind ($7.18 in chips)
Seat 2: Big Blind ($9.43 in chips)
Seat 3: Hero ($8.02 in chips)
Seat 4: UTGplus1 ($4.80 in chips)
Seat 5: UTGplus2 ($4.85 in chips)
Seat 6: Dealer ($4.91 in chips)
Small Blind: posts small blind $0.02
Big Blind: posts big blind $0.05
*** HOLE CARDS ***
Dealt to Hero [Qc 9s]
Hero: folds
UTGplus1: folds
UTGplus2: folds
Dealer: folds
Small Blind: calls $0.03 
Big Blind: checks
*** FLOP *** [Kd 5h 2h]
Small Blind: bets $0.10 
Big Blind: calls $0.10 
*** TURN *** [Kd 5h 2h] [9c]
Small Blind: bets $0.30 
Big Blind: folds
Uncalled bet ($0.30) returned to Small Blind
Small Blind: doesn't show hand
Small Blind collected $0.29 from pot
*** SUMMARY ***
Total pot $0.3 | Rake $0.01
Board [Kd 5h 2h 9c]
Seat 1: Small Blind (small blind) won ($0.29)
Seat 2: Big Blind (big blind) showed
Seat 3: Hero showed
Seat 4: UTGplus1 showed
Seat 5: UTGplus2 showed
Seat 6: Dealer (button) showed



PokerStars Zoom Hand #3434354160: Hold'em No Limit ($0.02/$0.05) - 2017/03/08 23:33:21
Table '#952' 6-max Seat #2 is the button
Seat 1: UTGplus2 ($0.62 in chips)
Seat 2: Hero ($8.02 in chips)
Seat 3: Small Blind ($25.53 in chips)
Seat 4: Big Blind ($4.88 in chips)
Seat 5: UTG ($1.06 in chips)
Seat 6: UTGplus1 ($3.24 in chips)
Small Blind: posts small blind $0.02
Big Blind: posts big blind $0.05
*** HOLE CARDS ***
Dealt to Hero [8h Th]
UTG: folds
UTGplus1: raises $0.17 to $0.17
UTGplus2: raises $0.45 to $0.62 and is all-in
Hero: folds
Small Blind: folds
Big Blind: folds
UTGplus1: calls $0.45 
*** FLOP *** [2d Kh Ac]
*** TURN *** [2d Kh Ac] [8s]
*** RIVER *** [2d Kh Ac 8s] [Ts]
*** SHOW DOWN ***
UTGplus2: shows [As 2c] (two pair, Aces and Kings)
UTGplus1: shows [Kc Ad] (two pair, Aces and Tens)
UTGplus1 collected $1.25 from pot
Seat re-join
*** SUMMARY ***
Total pot $1.31 | Rake $0.06
Board [2d Kh Ac 8s Ts]
Seat 1: UTGplus2 showed [As 2c] and lost with two pair, Aces and Kings
Seat 2: Hero (button) showed
Seat 3: Small Blind (small blind) showed
Seat 4: Big Blind (big blind) showed
Seat 5: UTG showed
Seat 6: UTGplus1 showed [Kc Ad] and won ($1.25) with two pair, Aces and Tens



PokerStars Zoom Hand #3434354378: Hold'em No Limit ($0.02/$0.05) - 2017/03/08 23:33:49
Table '#952' 6-max Seat #5 is the button
Seat 1: Big Blind ($3.48 in chips)
Seat 2: UTG ($5.56 in chips)
Seat 3: UTGplus1 ($3.63 in chips)
Seat 4: UTGplus2 ($4.96 in chips)
Seat 5: Dealer ($5.45 in chips)
Seat 6: Hero ($8.02 in chips)
Hero: posts small blind $0.02
Big Blind: posts big blind $0.05
*** HOLE CARDS ***
Dealt to Hero [3h 2s]
UTG: folds
UTGplus1: folds
UTGplus2: folds
Dealer: folds
Hero: folds
*** SHOW DOWN ***
Big Blind: shows [6c 2h] (high card Six)
Big Blind collected $0.07 from pot
*** SUMMARY ***
Total pot $0.07 | Rake $0.00
Seat 1: Big Blind (big blind) collected $0.02
Seat 2: UTG showed
Seat 3: UTGplus1 showed
Seat 4: UTGplus2 showed
Seat 5: Dealer (button) showed
Seat 6: Hero (small blind) showed



PokerStars Zoom Hand #3434354433: Hold'em No Limit ($0.02/$0.05) - 2017/03/08 23:33:55
Table '#952' 6-max Seat #6 is the button
Seat 1: Small Blind ($20.59 in chips)
Seat 2: Big Blind ($5.56 in chips)
Seat 3: Hero ($8 in chips)
Seat 4: UTGplus1 ($9.28 in chips)
Seat 5: UTGplus2 ($9.33 in chips)
Seat 6: Dealer ($3.40 in chips)
Small Blind: posts small blind $0.02
Big Blind: posts big blind $0.05
*** HOLE CARDS ***
Dealt to Hero [3s Kh]
Hero: folds
UTGplus1: raises $0.15 to $0.15
UTGplus2: folds
Dealer: folds
Small Blind: folds
Big Blind: folds
Uncalled bet ($0.10) returned to UTGplus1
UTGplus1: doesn't show hand
UTGplus1 collected $0.12 from pot
*** SUMMARY ***
Total pot $0.12 | Rake $0.00
Seat 1: Small Blind (small blind) showed
Seat 2: Big Blind (big blind) showed
Seat 3: Hero showed
Seat 4: UTGplus1 won ($0.12)
Seat 5: UTGplus2 showed
Seat 6: Dealer (button) showed



PokerStars Zoom Hand #3434354482: Hold'em No Limit ($0.02/$0.05) - 2017/03/08 23:34:00
Table '#952' 6-max Seat #6 is the button
Seat 1: Small Blind ($20.57 in chips)
Seat 2: Hero ($8 in chips)
Seat 3: UTG ($7.43 in chips)
Seat 4: UTGplus1 ($9.33 in chips)
Seat 5: UTGplus2 ($3.63 in chips)
Seat 6: Dealer ($1.52 in chips)
Small Blind: posts small blind $0.02
Hero: posts big blind $0.05
*** HOLE CARDS ***
Dealt to Hero [9d 6s]
UTG: folds
UTGplus1: folds
UTGplus2: folds
Dealer: raises $0.17 to $0.17
Small Blind: calls $0.15 
Hero: folds
*** FLOP *** [Ad Th Qh]
Small Blind: checks
Dealer: bets $0.25 
Small Blind: calls $0.25 
*** TURN *** [Ad Th Qh] [4h]
Small Blind: checks
Dealer: checks
*** RIVER *** [Ad Th Qh 4h] [7c]
Small Blind: checks
Dealer: checks
*** SHOW DOWN ***
Small Blind: shows [Qs Kd] (a pair of Queens)
Dealer: shows [6h 6c] (One pair)
Small Blind collected $0.85 from pot
*** SUMMARY ***
Total pot $0.89 | Rake $0.04
Board [Ad Th Qh 4h 7c]
Seat 1: Small Blind (small blind) showed [Qs Kd] and won ($0.85) with a pair of Queens
Seat 2: Hero (big blind) showed
Seat 3: UTG showed
Seat 4: UTGplus1 showed
Seat 5: UTGplus2 showed
Seat 6: Dealer (button) showed [6h 6c]



PokerStars Zoom Hand #3434354526: Hold'em No Limit ($0.02/$0.05) - 2017/03/08 23:34:05
Table '#952' 6-max Seat #3 is the button
Seat 1: UTGplus1 ($22.10 in chips)
Seat 2: UTGplus2 ($1.35 in chips)
Seat 3: Dealer ($5.63 in chips)
Seat 4: Hero ($7.95 in chips)
Seat 5: Big Blind ($5 in chips)
Seat 6: UTG ($2.54 in chips)
Hero: posts small blind $0.02
Big Blind: posts big blind $0.05
*** HOLE CARDS ***
Dealt to Hero [Jc 4s]
UTG: calls $0.05 
UTGplus1: folds
UTGplus2: folds
Dealer: folds
Hero: folds
Big Blind: checks
*** FLOP *** [8h 9c Qc]
Big Blind: checks
UTG: bets $0.05 
Big Blind: folds
Uncalled bet ($0.05) returned to UTG
UTG: doesn't show hand
UTG collected $0.12 from pot
*** SUMMARY ***
Total pot $0.12 | Rake $0.00
Board [8h 9c Qc]
Seat 1: UTGplus1 showed
Seat 2: UTGplus2 showed
Seat 3: Dealer (button) showed
Seat 4: Hero (small blind) showed
Seat 5: Big Blind (big blind) showed
Seat 6: UTG won ($0.12)



PokerStars Zoom Hand #3434354579: Hold'em No Limit ($0.02/$0.05) - 2017/03/08 23:34:11
Table '#952' 6-max Seat #4 is the button
Seat 1: UTG ($1.01 in chips)
Seat 2: Hero ($7.93 in chips)
Seat 3: UTGplus2 ($11.73 in chips)
Seat 4: Dealer ($4.83 in chips)
Seat 5: Small Blind ($7.05 in chips)
Seat 6: Big Blind ($1.93 in chips)
Small Blind: posts small blind $0.02
Big Blind: posts big blind $0.05
*** HOLE CARDS ***
Dealt to Hero [Tc 9d]
UTG: folds
Hero: calls $0.05 
UTGplus2: folds
Dealer: folds
Small Blind: folds
Big Blind: checks
*** FLOP *** [7c Qh 8c]
Big Blind: checks
Hero: bets $0.12 
Big Blind: folds
Uncalled bet ($0.12) returned to Hero
Hero: doesn't show hand
Hero collected $0.12 from pot
*** SUMMARY ***
Total pot $0.12 | Rake $0.00
Board [7c Qh 8c]
Seat 1: UTG showed
Seat 2: Hero won ($0.12)
Seat 3: UTGplus2 showed
Seat 4: Dealer (button) showed
Seat 5: Small Blind (small blind) showed
Seat 6: Big Blind (big blind) showed



PokerStars Zoom Hand #3434354823: Hold'em No Limit ($0.02/$0.05) - 2017/03/08 23:34:44
Table '#952' 6-max Seat #3 is the button
Seat 1: UTGplus1 ($7.61 in chips)
Seat 2: Hero ($8 in chips)
Seat 3: Dealer ($2.82 in chips)
Seat 4: Small Blind ($5.28 in chips)
Seat 5: Big Blind ($5 in chips)
Seat 6: UTG ($5.59 in chips)
Small Blind: posts small blind $0.02
Big Blind: posts big blind $0.05
*** HOLE CARDS ***
Dealt to Hero [8h 6h]
UTG: folds
UTGplus1: calls $0.05 
Hero: calls $0.05 
Dealer: raises $0.25 to $0.25
Small Blind: folds
Big Blind: folds
UTGplus1: calls $0.20 
Hero: calls $0.20 
*** FLOP *** [Th 2d 6c]
UTGplus1: checks
Hero: checks
Dealer: bets $0.57 
UTGplus1: folds
Hero: folds
Uncalled bet ($0.57) returned to Dealer
Dealer: doesn't show hand
Dealer collected $0.78 from pot
Seat re-join
*** SUMMARY ***
Total pot $0.82 | Rake $0.04
Board [Th 2d 6c]
Seat 1: UTGplus1 showed
Seat 2: Hero showed
Seat 3: Dealer (button) won ($0.78)
Seat 4: Small Blind (small blind) showed
Seat 5: Big Blind (big blind) showed
Seat 6: UTG showed



PokerStars Zoom Hand #3434355138: Hold'em No Limit ($0.02/$0.05) - 2017/03/08 23:35:22
Table '#952' 6-max Seat #6 is the button
Seat 1: Small Blind ($6.12 in chips)
Seat 2: Big Blind ($3.52 in chips)
Seat 3: UTG ($3.91 in chips)
Seat 4: UTGplus1 ($2.26 in chips)
Seat 5: UTGplus2 ($6.19 in chips)
Seat 6: Hero ($7.75 in chips)
Small Blind: posts small blind $0.02
Big Blind: posts big blind $0.05
*** HOLE CARDS ***
Dealt to Hero [8s 3c]
UTG: folds
UTGplus1: raises $0.10 to $0.10
UTGplus2: folds
Hero: folds
Small Blind: calls $0.08 
Big Blind: calls $0.05 
*** FLOP *** [4s 2h 2d]
Small Blind: checks
Big Blind: checks
UTGplus1: bets $0.10 
Small Blind: folds
Big Blind: calls $0.10 
*** TURN *** [4s 2h 2d] [3d]
Big Blind: checks
UTGplus1: bets $0.15 
Big Blind: folds
Uncalled bet ($0.15) returned to UTGplus1
UTGplus1: doesn't show hand
UTGplus1 collected $0.48 from pot
*** SUMMARY ***
Total pot $0.5 | Rake $0.02
Board [4s 2h 2d 3d]
Seat 1: Small Blind (small blind) showed
Seat 2: Big Blind (big blind) showed
Seat 3: UTG showed
Seat 4: UTGplus1 won ($0.48)
Seat 5: UTGplus2 showed
Seat 6: Hero (button) showed



PokerStars Zoom Hand #3434355216: Hold'em No Limit ($0.02/$0.05) - 2017/03/08 23:35:31
Table '#952' 6-max Seat #1 is the button
Seat 1: Dealer ($2.33 in chips)
Seat 2: Small Blind ($2.44 in chips)
Seat 3: Hero ($7.75 in chips)
Seat 4: UTG ($4.92 in chips)
Seat 5: UTGplus1 ($2.01 in chips)
Seat 6: UTGplus2 ($7.36 in chips)
Small Blind: posts small blind $0.02
Hero: posts big blind $0.05
*** HOLE CARDS ***
Dealt to Hero [8d 6h]
UTG: folds
UTGplus1: folds
UTGplus2: calls $0.05 
Dealer: calls $0.05 
Small Blind: raises $2.39 to $2.44 and is all-in
Hero: folds
UTGplus2: folds
Dealer: folds 
Uncalled bet ($2.39) returned to Small Blind
Small Blind: doesn't show hand
Small Blind collected $0.2 from pot
*** SUMMARY ***
Total pot $0.2 | Rake $0.00
Seat 1: Dealer (button) showed
Seat 2: Small Blind (small blind) won ($0.2)
Seat 3: Hero (big blind) showed
Seat 4: UTG showed
Seat 5: UTGplus1 showed
Seat 6: UTGplus2 showed



PokerStars Zoom Hand #3434355264: Hold'em No Limit ($0.02/$0.05) - 2017/03/08 23:35:37
Table '#952' 6-max Seat #4 is the button
Seat 1: Hero ($7.70 in chips)
Seat 2: UTGplus1 ($2.01 in chips)
Seat 3: UTGplus2 ($5.73 in chips)
Seat 4: Dealer ($3.35 in chips)
Seat 5: Small Blind ($8.99 in chips)
Seat 6: Big Blind ($10.74 in chips)
Small Blind: posts small blind $0.02
Big Blind: posts big blind $0.05
*** HOLE CARDS ***
Dealt to Hero [Th 7s]
Hero: folds
UTGplus1: folds
UTGplus2: raises $0.15 to $0.15
Dealer: folds
Small Blind: folds
Big Blind: folds
Uncalled bet ($0.10) returned to UTGplus2
UTGplus2: doesn't show hand
UTGplus2 collected $0.12 from pot
*** SUMMARY ***
Total pot $0.12 | Rake $0.00
Seat 1: Hero showed
Seat 2: UTGplus1 showed
Seat 3: UTGplus2 won ($0.12)
Seat 4: Dealer (button) showed
Seat 5: Small Blind (small blind) showed
Seat 6: Big Blind (big blind) showed



PokerStars Zoom Hand #3434355297: Hold'em No Limit ($0.02/$0.05) - 2017/03/08 23:35:41
Table '#952' 6-max Seat #6 is the button
Seat 1: Small Blind ($2.61 in chips)
Seat 2: Big Blind ($2.01 in chips)
Seat 3: UTG ($7.46 in chips)
Seat 4: Hero ($7.70 in chips)
Seat 5: UTGplus2 ($7.46 in chips)
Seat 6: Dealer ($9.49 in chips)
Small Blind: posts small blind $0.02
Big Blind: posts big blind $0.05
*** HOLE CARDS ***
Dealt to Hero [9h Ac]
UTG: folds
Hero: folds
UTGplus2: folds
Dealer: folds
Small Blind: folds
*** SHOW DOWN ***
Big Blind: shows [Jc 4d] (high card Jack)
Big Blind collected $0.07 from pot
Table deposit $4.03 
Seat re-join
*** SUMMARY ***
Total pot $0.07 | Rake $0.00
Seat 1: Small Blind (small blind) showed
Seat 2: Big Blind (big blind) collected $0.02
Seat 3: UTG showed
Seat 4: Hero showed
Seat 5: UTGplus2 showed
Seat 6: Dealer (button) showed



PokerStars Zoom Hand #3434355342: Hold'em No Limit ($0.02/$0.05) - 2017/03/08 23:35:47
Table '#952' 6-max Seat #2 is the button
Seat 1: Hero ($7.70 in chips)
Seat 2: Dealer ($5 in chips)
Seat 3: Small Blind ($7.46 in chips)
Seat 4: Big Blind ($2.50 in chips)
Seat 5: UTG ($3.88 in chips)
Seat 6: UTGplus1 ($0.95 in chips)
Small Blind: posts small blind $0.02
Big Blind: posts big blind $0.05
*** HOLE CARDS ***
Dealt to Hero [5d 2c]
UTG: calls $0.05 
UTGplus1: folds
Hero: folds
Dealer: folds
Small Blind: calls $0.03 
Big Blind: checks
*** FLOP *** [2d Jc 9d]
Small Blind: checks
Big Blind: checks
UTG: bets $0.10 
Small Blind: folds
Big Blind: folds
Uncalled bet ($0.10) returned to UTG
UTG: doesn't show hand
UTG collected $0.15 from pot
*** SUMMARY ***
Total pot $0.15 | Rake $0.00
Board [2d Jc 9d]
Seat 1: Hero showed
Seat 2: Dealer (button) showed
Seat 3: Small Blind (small blind) showed
Seat 4: Big Blind (big blind) showed
Seat 5: UTG won ($0.15)
Seat 6: UTGplus1 showed



PokerStars Zoom Hand #3434355380: Hold'em No Limit ($0.02/$0.05) - 2017/03/08 23:35:51
Table '#952' 6-max Seat #3 is the button
Seat 1: UTGplus1 ($2.45 in chips)
Seat 2: Hero ($7.70 in chips)
Seat 3: Dealer ($0.95 in chips)
Seat 4: Small Blind ($3.56 in chips)
Seat 5: Big Blind ($2.19 in chips)
Seat 6: UTG ($8.18 in chips)
Small Blind: posts small blind $0.02
Big Blind: posts big blind $0.05
*** HOLE CARDS ***
Dealt to Hero [Qd Kc]
UTG: folds
UTGplus1: folds
Hero: raises $0.17 to $0.17
Dealer: folds
Small Blind: calls $0.15 
Big Blind: calls $0.12 
*** FLOP *** [Ac Jh 5h]
Small Blind: bets $0.25 
Big Blind: folds
Hero: calls $0.25 
*** TURN *** [Ac Jh 5h] [5c]
Small Blind: bets $0.23 
Hero: calls $0.23 
*** RIVER *** [Ac Jh 5h 5c] [9h]
Small Blind: checks
Hero: checks
*** SHOW DOWN ***
Small Blind: shows [7s Ks] (a pair of Fives)
Hero: shows [Qd Kc] (a pair of Fives)
Hero collected $1.4 from pot
Seat re-join
*** SUMMARY ***
Total pot $1.47 | Rake $0.07
Board [Ac Jh 5h 5c 9h]
Seat 1: UTGplus1 showed
Seat 2: Hero showed [Qd Kc] and won ($1.4) with a pair of Fives
Seat 3: Dealer (button) showed
Seat 4: Small Blind (small blind) showed [7s Ks] and lost with a pair of Fives
Seat 5: Big Blind (big blind) showed
Seat 6: UTG showed



PokerStars Zoom Hand #3434355867: Hold'em No Limit ($0.02/$0.05) - 2017/03/08 23:36:50
Table '#952' 6-max Seat #6 is the button
Seat 1: Hero ($8.45 in chips)
Seat 2: Big Blind ($2.91 in chips)
Seat 3: UTG ($7.06 in chips)
Seat 4: UTGplus1 ($1.88 in chips)
Seat 5: UTGplus2 ($5 in chips)
Seat 6: Dealer ($3.45 in chips)
Hero: posts small blind $0.02
Big Blind: posts big blind $0.05
*** HOLE CARDS ***
Dealt to Hero [5s 2d]
UTG: folds
UTGplus1: folds
UTGplus2: folds
Dealer: raises $0.17 to $0.17
Hero: folds (auth)
Hero: Table leave user
Big Blind: folds
Uncalled bet ($0.12) returned to Dealer
Dealer: doesn't show hand
Dealer collected $0.12 from pot
*** SUMMARY ***
Total pot $0.12 | Rake $0.00
Seat 1: Hero (small blind) showed
Seat 2: Big Blind (big blind) showed
Seat 3: UTG showed
Seat 4: UTGplus1 showed
Seat 5: UTGplus2 showed
Seat 6: Dealer (button) won ($0.12)




