PokerStars Zoom Hand #3434276051: Hold'em No Limit ($0.02/$0.05) - 2017/03/08 20:55:07
Table '#952' 6-max Seat #2 is the button
Seat 1: UTGplus2 ($10.99 in chips)
Seat 2: Dealer ($4.95 in chips)
Seat 3: Small Blind ($4.63 in chips)
Seat 4: Hero ($5 in chips)
Seat 5: UTG ($10.26 in chips)
Seat 6: UTGplus1 ($2.84 in chips)
Small Blind: posts small blind $0.02
Hero: posts big blind $0.05
*** HOLE CARDS ***
Dealt to Hero [Th Ah]
UTG: folds
UTGplus1: raises $0.15 to $0.15
UTGplus2: calls $0.15 
Dealer: folds
Small Blind: folds
Hero: raises $0.57 to $0.62
UTGplus1: calls $0.47 
UTGplus2: folds
*** FLOP *** [8h Jc 6c]
Hero: bets $0.75 
UTGplus1: folds
Uncalled bet ($0.75) returned to Hero
Hero: doesn't show hand
Hero collected $1.34 from pot
*** SUMMARY ***
Total pot $1.41 | Rake $0.07
Board [8h Jc 6c]
Seat 1: UTGplus2 showed
Seat 2: Dealer (button) showed
Seat 3: Small Blind (small blind) showed
Seat 4: Hero (big blind) won ($1.34)
Seat 5: UTG showed
Seat 6: UTGplus1 showed



PokerStars Zoom Hand #3434276456: Hold'em No Limit ($0.02/$0.05) - 2017/03/08 20:55:58
Table '#952' 6-max Seat #5 is the button
Seat 1: Big Blind ($8 in chips)
Seat 2: UTG ($4.63 in chips)
Seat 3: UTGplus1 ($6.92 in chips)
Seat 4: Hero ($5.72 in chips)
Seat 5: Dealer ($5 in chips)
Seat 6: Small Blind ($2.08 in chips)
Small Blind: posts small blind $0.02
Big Blind: posts big blind $0.05
*** HOLE CARDS ***
Dealt to Hero [Tc 2s]
UTG: folds
UTGplus1: raises $0.15 to $0.15
Hero: folds
Dealer: folds
Small Blind: folds
Big Blind: raises $0.70 to $0.75
UTGplus1: calls $0.60 
*** FLOP *** [7d 4s 6c]
Big Blind: bets $1.45 
UTGplus1: calls $1.45 
*** TURN *** [7d 4s 6c] [3d]
Big Blind: bets $5.27 
UTGplus1: folds
Uncalled bet ($5.27) returned to Big Blind
Big Blind: doesn't show hand
Big Blind collected $4.2 from pot
*** SUMMARY ***
Total pot $4.42 | Rake $0.22
Board [7d 4s 6c 3d]
Seat 1: Big Blind (big blind) won ($4.2)
Seat 2: UTG showed
Seat 3: UTGplus1 showed
Seat 4: Hero showed
Seat 5: Dealer (button) showed
Seat 6: Small Blind (small blind) showed



PokerStars Zoom Hand #3434276507: Hold'em No Limit ($0.02/$0.05) - 2017/03/08 20:56:04
Table '#952' 6-max Seat #5 is the button
Seat 1: Big Blind ($7.27 in chips)
Seat 2: UTG ($4.34 in chips)
Seat 3: UTGplus1 ($2.50 in chips)
Seat 4: UTGplus2 ($6.96 in chips)
Seat 5: Hero ($5.72 in chips)
Seat 6: Small Blind ($4.55 in chips)
Small Blind: posts small blind $0.02
Big Blind: posts big blind $0.05
*** HOLE CARDS ***
Dealt to Hero [9s 3c]
UTG: folds
UTGplus1: calls $0.05 
UTGplus2: calls $0.05 
Hero: folds
Small Blind: folds
Big Blind: checks
*** FLOP *** [2s 2c Kh]
Big Blind: checks
UTGplus1: bets $0.08 
UTGplus2: calls $0.08 
Big Blind: folds
*** TURN *** [2s 2c Kh] [5c]
UTGplus1: checks
UTGplus2: bets $0.16 
UTGplus1: folds
Uncalled bet ($0.16) returned to UTGplus2
UTGplus2: doesn't show hand
UTGplus2 collected $0.32 from pot
*** SUMMARY ***
Total pot $0.33 | Rake $0.01
Board [2s 2c Kh 5c]
Seat 1: Big Blind (big blind) showed
Seat 2: UTG showed
Seat 3: UTGplus1 showed
Seat 4: UTGplus2 won ($0.32)
Seat 5: Hero (button) showed
Seat 6: Small Blind (small blind) showed



PokerStars Zoom Hand #3434276593: Hold'em No Limit ($0.02/$0.05) - 2017/03/08 20:56:14
Table '#952' 6-max Seat #6 is the button
Seat 1: Small Blind ($6.24 in chips)
Seat 2: Big Blind ($4.91 in chips)
Seat 3: UTG ($4.93 in chips)
Seat 4: UTGplus1 ($9.78 in chips)
Seat 5: Hero ($5.72 in chips)
Seat 6: Dealer ($5.28 in chips)
Small Blind: posts small blind $0.02
Big Blind: posts big blind $0.05
*** HOLE CARDS ***
Dealt to Hero [2h 8c]
UTG: folds
UTGplus1: raises $0.15 to $0.15
Hero: folds
Dealer: folds 
Small Blind: folds
Big Blind: folds
Uncalled bet ($0.10) returned to UTGplus1
UTGplus1: doesn't show hand
UTGplus1 collected $0.12 from pot
*** SUMMARY ***
Total pot $0.12 | Rake $0.00
Seat 1: Small Blind (small blind) showed
Seat 2: Big Blind (big blind) showed
Seat 3: UTG showed
Seat 4: UTGplus1 won ($0.12)
Seat 5: Hero showed
Seat 6: Dealer (button) showed



PokerStars Zoom Hand #3434276686: Hold'em No Limit ($0.02/$0.05) - 2017/03/08 20:56:25
Table '#952' 6-max Seat #5 is the button
Seat 1: Big Blind ($6.07 in chips)
Seat 2: UTG ($2.59 in chips)
Seat 3: UTGplus1 ($5 in chips)
Seat 4: UTGplus2 ($4.93 in chips)
Seat 5: Hero ($5.72 in chips)
Seat 6: Small Blind ($2.15 in chips)
Small Blind: posts small blind $0.02
Big Blind: posts big blind $0.05
*** HOLE CARDS ***
Dealt to Hero [6d 9c]
UTG: folds
UTGplus1: folds
UTGplus2: folds
Hero: folds
Small Blind: folds
Big Blind: doesn't show hand
Big Blind collected $0.07 from pot
*** SUMMARY ***
Total pot $0.07 | Rake $0.00
Seat 1: Big Blind (big blind) won ($0.07)
Seat 2: UTG showed
Seat 3: UTGplus1 showed
Seat 4: UTGplus2 showed
Seat 5: Hero (button) showed
Seat 6: Small Blind (small blind) showed



PokerStars Zoom Hand #3434276735: Hold'em No Limit ($0.02/$0.05) - 2017/03/08 20:56:31
Table '#952' 6-max Seat #2 is the button
Seat 1: UTGplus2 ($3.21 in chips)
Seat 2: Dealer ($4.70 in chips)
Seat 3: Hero ($5.72 in chips)
Seat 4: Big Blind ($3.48 in chips)
Seat 5: UTG ($5.02 in chips)
Seat 6: UTGplus1 ($4.65 in chips)
Hero: posts small blind $0.02
Big Blind: posts big blind $0.05
*** HOLE CARDS ***
Dealt to Hero [Th Td]
UTG: raises $0.15 to $0.15
UTGplus1: folds
UTGplus2: folds
Dealer: raises $0.57 to $0.57
Hero: calls $0.55 
Big Blind: raises $2.91 to $3.48 and is all-in
UTG: folds
Dealer: calls $2.91 
Hero: folds
*** FLOP *** [2h Jh Jc]
*** TURN *** [2h Jh Jc] [4s]
*** RIVER *** [2h Jh Jc 4s] [6h]
*** SHOW DOWN ***
Dealer: shows [8c 8d] (two pair, Jacks and Sixs)
Big Blind: shows [Kd Ks] (two pair, Kings and Sixs)
Big Blind collected $7.3 from pot
*** SUMMARY ***
Total pot $7.68 | Rake $0.38
Board [2h Jh Jc 4s 6h]
Seat 1: UTGplus2 showed
Seat 2: Dealer (button) showed [8c 8d] and lost with two pair, Jacks and Sixes
Seat 3: Hero (small blind) showed
Seat 4: Big Blind (big blind) showed [Kd Ks] and won ($7.3) with two pair, Kings and Sixes
Seat 5: UTG showed
Seat 6: UTGplus1 showed



PokerStars Zoom Hand #3434277169: Hold'em No Limit ($0.02/$0.05) - 2017/03/08 20:57:27
Table '#952' 6-max Seat #6 is the button
Seat 1: Small Blind ($4.89 in chips)
Seat 2: Big Blind ($6.14 in chips)
Seat 3: UTG ($1.22 in chips)
Seat 4: Hero ($5.15 in chips)
Seat 5: UTGplus2 ($7.30 in chips)
Seat 6: Dealer ($5 in chips)
Small Blind: posts small blind $0.02
Big Blind: posts big blind $0.05
*** HOLE CARDS ***
Dealt to Hero [4c Qh]
UTG: calls $0.05 
Hero: folds
UTGplus2: folds
Dealer: folds
Small Blind: calls $0.03 
Big Blind: checks
*** FLOP *** [Th 2d Jd]
Small Blind: checks
Big Blind: checks
UTG: checks
*** TURN *** [Th 2d Jd] [3h]
Small Blind: checks
Big Blind: checks
UTG: checks
*** RIVER *** [Th 2d Jd 3h] [Jh]
Small Blind: checks
Big Blind: checks
UTG: checks
*** SHOW DOWN ***
Small Blind: shows [Ad 8h] (a pair of Jacks)
Big Blind: shows [4s 6d] (One pair)
UTG: shows [7c Qc] (a pair of Jacks)
Small Blind collected $0.15 from pot
*** SUMMARY ***
Total pot $0.15 | Rake $0.00
Board [Th 2d Jd 3h Jh]
Seat 1: Small Blind (small blind) showed [Ad 8h] and won ($0.15) with a pair of Jacks
Seat 2: Big Blind (big blind) showed [4s 6d]
Seat 3: UTG showed [7c Qc] and lost with a pair of Jacks
Seat 4: Hero showed
Seat 5: UTGplus2 showed
Seat 6: Dealer (button) showed



PokerStars Zoom Hand #3434277212: Hold'em No Limit ($0.02/$0.05) - 2017/03/08 20:57:33
Table '#952' 6-max Seat #4 is the button
Seat 1: UTG ($7.30 in chips)
Seat 2: Hero ($5.15 in chips)
Seat 3: UTGplus2 ($2.84 in chips)
Seat 4: Dealer ($8.82 in chips)
Seat 5: Small Blind ($4.87 in chips)
Seat 6: Big Blind ($5 in chips)
Small Blind: posts small blind $0.02
Big Blind: posts big blind $0.05
*** HOLE CARDS ***
Dealt to Hero [Ks 5d]
UTG: folds
Hero: folds
UTGplus2: folds
Dealer: raises $0.12 to $0.12
Small Blind: folds
Big Blind: folds
Uncalled bet ($0.07) returned to Dealer
Dealer: doesn't show hand
Dealer collected $0.12 from pot
*** SUMMARY ***
Total pot $0.12 | Rake $0.00
Seat 1: UTG showed
Seat 2: Hero showed
Seat 3: UTGplus2 showed
Seat 4: Dealer (button) won ($0.12)
Seat 5: Small Blind (small blind) showed
Seat 6: Big Blind (big blind) showed



PokerStars Zoom Hand #3434277263: Hold'em No Limit ($0.02/$0.05) - 2017/03/08 20:57:40
Table '#952' 6-max Seat #5 is the button
Seat 1: Hero ($5.15 in chips)
Seat 2: UTG ($1.71 in chips)
Seat 3: UTGplus1 ($1.61 in chips)
Seat 4: UTGplus2 ($4.02 in chips)
Seat 5: Dealer ($5 in chips)
Seat 6: Small Blind ($11.65 in chips)
Small Blind: posts small blind $0.02
Hero: posts big blind $0.05
*** HOLE CARDS ***
Dealt to Hero [8c 8h]
UTG: folds 
UTGplus1: folds
UTGplus2: folds
Dealer: folds
Small Blind: folds
Hero: doesn't show hand
Hero collected $0.07 from pot
*** SUMMARY ***
Total pot $0.07 | Rake $0.00
Seat 1: Hero (big blind) won ($0.07)
Seat 2: UTG showed
Seat 3: UTGplus1 showed
Seat 4: UTGplus2 showed
Seat 5: Dealer (button) showed
Seat 6: Small Blind (small blind) showed



PokerStars Zoom Hand #3434277477: Hold'em No Limit ($0.02/$0.05) - 2017/03/08 20:58:05
Table '#952' 6-max Seat #5 is the button
Seat 1: Big Blind ($7.98 in chips)
Seat 2: UTG ($3.44 in chips)
Seat 3: UTGplus1 ($3.64 in chips)
Seat 4: UTGplus2 ($6.97 in chips)
Seat 5: Dealer ($14.78 in chips)
Seat 6: Hero ($5.17 in chips)
Hero: posts small blind $0.02
Big Blind: posts big blind $0.05
*** HOLE CARDS ***
Dealt to Hero [2s 9h]
UTG: folds
UTGplus1: folds 
UTGplus2: folds
Dealer: folds
Hero: folds
Big Blind: doesn't show hand
Big Blind collected $0.07 from pot
*** SUMMARY ***
Total pot $0.07 | Rake $0.00
Seat 1: Big Blind (big blind) won ($0.07)
Seat 2: UTG showed
Seat 3: UTGplus1 showed
Seat 4: UTGplus2 showed
Seat 5: Dealer (button) showed
Seat 6: Hero (small blind) showed



PokerStars Zoom Hand #3434277539: Hold'em No Limit ($0.02/$0.05) - 2017/03/08 20:58:12
Table '#952' 6-max Seat #1 is the button
Seat 1: Hero ($5.15 in chips)
Seat 2: Small Blind ($2.44 in chips)
Seat 3: Big Blind ($6.30 in chips)
Seat 4: UTG ($6.76 in chips)
Seat 5: UTGplus1 ($4.09 in chips)
Seat 6: UTGplus2 ($2.52 in chips)
Small Blind: posts small blind $0.02
Big Blind: posts big blind $0.05
*** HOLE CARDS ***
Dealt to Hero [Kh Qd]
UTG: folds
UTGplus1: raises $0.16 to $0.16
UTGplus2: folds
Hero: raises $0.55 to $0.55
Small Blind: folds
Big Blind: folds
UTGplus1: raises $1.26 to $1.42
Hero: calls $0.87 
*** FLOP *** [Td Qc 6h]
UTGplus1: bets $2.67 and is all-in
Hero: calls $2.67 
*** TURN *** [Td Qc 6h] [4h]
*** RIVER *** [Td Qc 6h 4h] [4s]
*** SHOW DOWN ***
Hero: shows [Kh Qd] (two pair, Queens and Kings)
UTGplus1: shows [As Ad] (two pair, Aces and Queens)
UTGplus1 collected $7.84 from pot
*** SUMMARY ***
Total pot $8.25 | Rake $0.41
Board [Td Qc 6h 4h 4s]
Seat 1: Hero (button) showed [Kh Qd] and lost with two pair, Queens and Kings
Seat 2: Small Blind (small blind) showed
Seat 3: Big Blind (big blind) showed
Seat 4: UTG showed
Seat 5: UTGplus1 showed [As Ad] and won ($7.84) with two pair, Aces and Queens
Seat 6: UTGplus2 showed



PokerStars Zoom Hand #3434277957: Hold'em No Limit ($0.02/$0.05) - 2017/03/08 20:59:05
Table '#952' 6-max Seat #1 is the button
Seat 1: Dealer ($6.29 in chips)
Seat 2: Small Blind ($2.82 in chips)
Seat 3: Big Blind ($6.72 in chips)
Seat 4: UTG ($5.19 in chips)
Seat 5: UTGplus1 ($5.14 in chips)
Seat 6: Hero ($1.06 in chips)
Small Blind: posts small blind $0.02
Big Blind: posts big blind $0.05
*** HOLE CARDS ***
Dealt to Hero [2s 2d]
UTG: folds
UTGplus1: folds
Hero: raises $0.17 to $0.17
Dealer: folds
Small Blind: folds
Big Blind: folds
Uncalled bet ($0.12) returned to Hero
Hero: doesn't show hand
Hero collected $0.12 from pot
*** SUMMARY ***
Total pot $0.12 | Rake $0.00
Seat 1: Dealer (button) showed
Seat 2: Small Blind (small blind) showed
Seat 3: Big Blind (big blind) showed
Seat 4: UTG showed
Seat 5: UTGplus1 showed
Seat 6: Hero won ($0.12)



PokerStars Zoom Hand #3434278169: Hold'em No Limit ($0.02/$0.05) - 2017/03/08 20:59:32
Table '#952' 6-max Seat #2 is the button
Seat 1: UTGplus2 ($10.12 in chips)
Seat 2: Dealer ($0.92 in chips)
Seat 3: Hero ($5 in chips)
Seat 4: Big Blind ($4.81 in chips)
Seat 5: UTG ($5.12 in chips)
Seat 6: UTGplus1 ($3.48 in chips)
Hero: posts small blind $0.02
Big Blind: posts big blind $0.05
*** HOLE CARDS ***
Dealt to Hero [Qs Td]
UTG: folds
UTGplus1: folds
UTGplus2: folds
Dealer: folds
Hero: folds
Big Blind: doesn't show hand
Big Blind collected $0.07 from pot
*** SUMMARY ***
Total pot $0.07 | Rake $0.00
Seat 1: UTGplus2 showed
Seat 2: Dealer (button) showed
Seat 3: Hero (small blind) showed
Seat 4: Big Blind (big blind) won ($0.07)
Seat 5: UTG showed
Seat 6: UTGplus1 showed



PokerStars Zoom Hand #3434278251: Hold'em No Limit ($0.02/$0.05) - 2017/03/08 20:59:42
Table '#952' 6-max Seat #1 is the button
Seat 1: Dealer ($5.39 in chips)
Seat 2: Hero ($4.98 in chips)
Seat 3: Big Blind ($5.61 in chips)
Seat 4: UTG ($11.69 in chips)
Seat 5: UTGplus1 ($14.23 in chips)
Seat 6: UTGplus2 ($5.19 in chips)
Hero: posts small blind $0.02
Big Blind: posts big blind $0.05
*** HOLE CARDS ***
Dealt to Hero [5s Jh]
UTG: calls $0.05 
UTGplus1: folds
UTGplus2: folds
Dealer: folds
Hero: folds
Big Blind: checks
*** FLOP *** [2c Jd Qd]
Big Blind: checks
UTG: checks
*** TURN *** [2c Jd Qd] [Ah]
Big Blind: checks
UTG: checks
*** RIVER *** [2c Jd Qd Ah] [9d]
Big Blind: checks
UTG: checks
*** SHOW DOWN ***
Big Blind: shows [9c 7h] (a pair of Nines)
UTG: shows [6c 6h] (a pair of Sixs)
Big Blind collected $0.12 from pot
*** SUMMARY ***
Total pot $0.12 | Rake $0.00
Board [2c Jd Qd Ah 9d]
Seat 1: Dealer (button) showed
Seat 2: Hero (small blind) showed
Seat 3: Big Blind (big blind) showed [9c 7h] and won ($0.12) with a pair of Sixes
Seat 4: UTG showed [6c 6h] and lost with a pair of Sixes
Seat 5: UTGplus1 showed
Seat 6: UTGplus2 showed



PokerStars Zoom Hand #3434278296: Hold'em No Limit ($0.02/$0.05) - 2017/03/08 20:59:47
Table '#952' 6-max Seat #6 is the button
Seat 1: Small Blind ($5 in chips)
Seat 2: Big Blind ($5.19 in chips)
Seat 3: UTG ($5.56 in chips)
Seat 4: UTGplus1 ($9.79 in chips)
Seat 5: Hero ($4.96 in chips)
Seat 6: Dealer ($6.97 in chips)
Small Blind: posts small blind $0.02
Big Blind: posts big blind $0.05
*** HOLE CARDS ***
Dealt to Hero [8c Qc]
UTG: raises $0.10 to $0.10
UTGplus1: folds
Hero: folds
Dealer: calls $0.10 
Small Blind: folds
Big Blind: calls $0.05 
*** FLOP *** [3d 3s 2h]
Big Blind: bets $0.26 
UTG: calls $0.26 
Dealer: folds
*** TURN *** [3d 3s 2h] [As]
Big Blind: bets $0.52 
UTG: calls $0.52 
*** RIVER *** [3d 3s 2h As] [2d]
Big Blind: checks
UTG: checks
*** SHOW DOWN ***
Big Blind: shows [4d 4c] (two pair, Fours and Aces)
UTG: shows [Qs Qh] (two pair, Queens and Aces)
UTG collected $1.79 from pot
Seat re-join
*** SUMMARY ***
Total pot $1.88 | Rake $0.09
Board [3d 3s 2h As 2d]
Seat 1: Small Blind (small blind) showed
Seat 2: Big Blind (big blind) showed [4d 4c] and lost with two pair, Fours and Aces
Seat 3: UTG showed [Qs Qh] and won ($1.79) with two pair, Queens and Aces
Seat 4: UTGplus1 showed
Seat 5: Hero showed
Seat 6: Dealer (button) showed



PokerStars Zoom Hand #3434278362: Hold'em No Limit ($0.02/$0.05) - 2017/03/08 20:59:55
Table '#952' 6-max Seat #3 is the button
Seat 1: UTGplus1 ($5.87 in chips)
Seat 2: UTGplus2 ($5.70 in chips)
Seat 3: Dealer ($5.98 in chips)
Seat 4: Small Blind ($5.34 in chips)
Seat 5: Hero ($4.96 in chips)
Seat 6: UTG ($2.33 in chips)
Small Blind: posts small blind $0.02
Hero: posts big blind $0.05
*** HOLE CARDS ***
Dealt to Hero [9d 4h]
UTG: raises $0.15 to $0.15
UTGplus1: folds
UTGplus2: folds
Dealer: folds
Small Blind: folds
Hero: folds
Uncalled bet ($0.10) returned to UTG
UTG: doesn't show hand
UTG collected $0.12 from pot
*** SUMMARY ***
Total pot $0.12 | Rake $0.00
Seat 1: UTGplus1 showed
Seat 2: UTGplus2 showed
Seat 3: Dealer (button) showed
Seat 4: Small Blind (small blind) showed
Seat 5: Hero (big blind) showed
Seat 6: UTG won ($0.12)



PokerStars Zoom Hand #3434278394: Hold'em No Limit ($0.02/$0.05) - 2017/03/08 21:00:00
Table '#952' 6-max Seat #2 is the button
Seat 1: UTGplus2 ($5.09 in chips)
Seat 2: Dealer ($1.93 in chips)
Seat 3: Hero ($4.91 in chips)
Seat 4: Big Blind ($1.04 in chips)
Seat 5: UTG ($5.32 in chips)
Seat 6: UTGplus1 ($5.98 in chips)
Hero: posts small blind $0.02
Big Blind: posts big blind $0.05
*** HOLE CARDS ***
Dealt to Hero [Qc 6c]
UTG: folds
UTGplus1: folds
UTGplus2: raises $0.17 to $0.17
Dealer: folds
Hero: folds
Big Blind: folds
Uncalled bet ($0.12) returned to UTGplus2
Big Blind: Table leave user
UTGplus2: doesn't show hand
UTGplus2 collected $0.12 from pot
Table leave user
Table deposit $4.91 
Seat re-join
*** SUMMARY ***
Total pot $0.12 | Rake $0.00
Seat 1: UTGplus2 won ($0.12)
Seat 2: Dealer (button) showed
Seat 3: Hero (small blind) showed
Seat 4: Big Blind (big blind) showed
Seat 5: UTG showed
Seat 6: UTGplus1 showed



PokerStars Zoom Hand #3434278427: Hold'em No Limit ($0.02/$0.05) - 2017/03/08 21:00:04
Table '#952' 6-max Seat #2 is the button
Seat 1: UTGplus2 ($5.98 in chips)
Seat 2: Dealer ($9.74 in chips)
Seat 3: Small Blind ($4.98 in chips)
Seat 4: Big Blind ($11.21 in chips)
Seat 5: Hero ($4.89 in chips)
Seat 6: UTGplus1 ($6.23 in chips)
Small Blind: posts small blind $0.02
Big Blind: posts big blind $0.05
*** HOLE CARDS ***
Dealt to Hero [Th 4h]
Hero: folds
UTGplus1: raises $0.15 to $0.15
UTGplus2: folds
Dealer: folds
Small Blind: folds
Big Blind: folds
Uncalled bet ($0.10) returned to UTGplus1
UTGplus1: doesn't show hand
UTGplus1 collected $0.12 from pot
*** SUMMARY ***
Total pot $0.12 | Rake $0.00
Seat 1: UTGplus2 showed
Seat 2: Dealer (button) showed
Seat 3: Small Blind (small blind) showed
Seat 4: Big Blind (big blind) showed
Seat 5: Hero showed
Seat 6: UTGplus1 won ($0.12)



PokerStars Zoom Hand #3434278468: Hold'em No Limit ($0.02/$0.05) - 2017/03/08 21:00:09
Table '#952' 6-max Seat #6 is the button
Seat 1: Small Blind ($9.74 in chips)
Seat 2: Hero ($4.89 in chips)
Seat 3: UTG ($3.50 in chips)
Seat 4: UTGplus1 ($4.95 in chips)
Seat 5: UTGplus2 ($4.83 in chips)
Seat 6: Dealer ($1.91 in chips)
Small Blind: posts small blind $0.02
Hero: posts big blind $0.05
*** HOLE CARDS ***
Dealt to Hero [3s 8s]
UTG: folds
UTGplus1: folds
UTGplus2: folds
Dealer: raises $0.15 to $0.15
Small Blind: folds
Hero: folds
Uncalled bet ($0.10) returned to Dealer
Dealer: doesn't show hand
Dealer collected $0.12 from pot
*** SUMMARY ***
Total pot $0.12 | Rake $0.00
Seat 1: Small Blind (small blind) showed
Seat 2: Hero (big blind) showed
Seat 3: UTG showed
Seat 4: UTGplus1 showed
Seat 5: UTGplus2 showed
Seat 6: Dealer (button) won ($0.12)



PokerStars Zoom Hand #3434278493: Hold'em No Limit ($0.02/$0.05) - 2017/03/08 21:00:14
Table '#952' 6-max Seat #5 is the button
Seat 1: Big Blind ($5 in chips)
Seat 2: UTG ($3.50 in chips)
Seat 3: Hero ($4.84 in chips)
Seat 4: UTGplus2 ($4.83 in chips)
Seat 5: Dealer ($2.59 in chips)
Seat 6: Small Blind ($5.12 in chips)
Small Blind: posts small blind $0.02
Big Blind: posts big blind $0.05
*** HOLE CARDS ***
Dealt to Hero [6h 3s]
UTG: folds
Hero: folds
UTGplus2: folds
Dealer: folds
Small Blind: folds
Big Blind: doesn't show hand
Big Blind collected $0.07 from pot
*** SUMMARY ***
Total pot $0.07 | Rake $0.00
Seat 1: Big Blind (big blind) won ($0.07)
Seat 2: UTG showed
Seat 3: Hero showed
Seat 4: UTGplus2 showed
Seat 5: Dealer (button) showed
Seat 6: Small Blind (small blind) showed



PokerStars Zoom Hand #3434278525: Hold'em No Limit ($0.02/$0.05) - 2017/03/08 21:00:20
Table '#952' 6-max Seat #5 is the button
Seat 1: Big Blind ($5.10 in chips)
Seat 2: Hero ($4.84 in chips)
Seat 3: UTGplus1 ($2.97 in chips)
Seat 4: UTGplus2 ($1.81 in chips)
Seat 5: Dealer ($4.81 in chips)
Seat 6: Small Blind ($5.07 in chips)
Small Blind: posts small blind $0.02
Big Blind: posts big blind $0.05
*** HOLE CARDS ***
Dealt to Hero [7h 2s]
Hero: folds
UTGplus1: folds
UTGplus2: raises $0.15 to $0.15
Dealer: folds
Small Blind: folds
Big Blind: calls $0.10 
*** FLOP *** [9c Js 8h]
Big Blind: bets $0.25 
UTGplus2: calls $0.25 
*** TURN *** [9c Js 8h] [Jd]
Big Blind: bets $1.70 
UTGplus2: folds
Uncalled bet ($1.70) returned to Big Blind
Big Blind: doesn't show hand
Big Blind collected $0.78 from pot
*** SUMMARY ***
Total pot $0.82 | Rake $0.04
Board [9c Js 8h Jd]
Seat 1: Big Blind (big blind) won ($0.78)
Seat 2: Hero showed
Seat 3: UTGplus1 showed
Seat 4: UTGplus2 showed
Seat 5: Dealer (button) showed
Seat 6: Small Blind (small blind) showed



PokerStars Zoom Hand #3434278551: Hold'em No Limit ($0.02/$0.05) - 2017/03/08 21:00:24
Table '#952' 6-max Seat #5 is the button
Seat 1: Big Blind ($4.81 in chips)
Seat 2: Hero ($4.84 in chips)
Seat 3: UTGplus1 ($4.83 in chips)
Seat 4: UTGplus2 ($6.39 in chips)
Seat 5: Dealer ($4.95 in chips)
Seat 6: Small Blind ($5.77 in chips)
Small Blind: posts small blind $0.02
Big Blind: posts big blind $0.05
*** HOLE CARDS ***
Dealt to Hero [4c Ks]
Hero: folds
UTGplus1: raises $0.15 to $0.15
UTGplus2: folds
Dealer: folds
Small Blind: folds
Big Blind: folds
Uncalled bet ($0.10) returned to UTGplus1
UTGplus1: doesn't show hand
UTGplus1 collected $0.12 from pot
Table deposit $2.50 
Seat re-join
*** SUMMARY ***
Total pot $0.12 | Rake $0.00
Seat 1: Big Blind (big blind) showed
Seat 2: Hero showed
Seat 3: UTGplus1 won ($0.12)
Seat 4: UTGplus2 showed
Seat 5: Dealer (button) showed
Seat 6: Small Blind (small blind) showed



PokerStars Zoom Hand #3434278598: Hold'em No Limit ($0.02/$0.05) - 2017/03/08 21:00:30
Table '#952' 6-max Seat #5 is the button
Seat 1: Big Blind ($4.95 in chips)
Seat 2: Hero ($4.84 in chips)
Seat 3: UTGplus1 ($5.07 in chips)
Seat 4: UTGplus2 ($10.14 in chips)
Seat 5: Dealer ($6.33 in chips)
Seat 6: Small Blind ($9.48 in chips)
Small Blind: posts small blind $0.02
Big Blind: posts big blind $0.05
*** HOLE CARDS ***
Dealt to Hero [9s 5h]
Hero: folds
UTGplus1: folds
UTGplus2: raises $0.20 to $0.20
Dealer: calls $0.20 
Small Blind: folds
Big Blind: calls $0.15 
*** FLOP *** [8d 2h 6c]
Big Blind: checks
UTGplus2: checks
Dealer: bets $0.41 
Big Blind: folds
UTGplus2: folds
Uncalled bet ($0.41) returned to Dealer
Dealer: doesn't show hand
Dealer collected $0.59 from pot
*** SUMMARY ***
Total pot $0.62 | Rake $0.03
Board [8d 2h 6c]
Seat 1: Big Blind (big blind) showed
Seat 2: Hero showed
Seat 3: UTGplus1 showed
Seat 4: UTGplus2 showed
Seat 5: Dealer (button) won ($0.59)
Seat 6: Small Blind (small blind) showed



PokerStars Zoom Hand #3434278653: Hold'em No Limit ($0.02/$0.05) - 2017/03/08 21:00:37
Table '#952' 6-max Seat #1 is the button
Seat 1: Dealer ($2.92 in chips)
Seat 2: Small Blind ($4.78 in chips)
Seat 3: Hero ($4.84 in chips)
Seat 4: UTG ($4.19 in chips)
Seat 5: UTGplus1 ($6.92 in chips)
Seat 6: UTGplus2 ($5.12 in chips)
Small Blind: posts small blind $0.02
Hero: posts big blind $0.05
*** HOLE CARDS ***
Dealt to Hero [5d 6s]
UTG: folds
UTGplus1: folds
UTGplus2: raises $0.15 to $0.15
Dealer: raises $0.45 to $0.45
Small Blind: folds
Hero: folds
UTGplus2: folds
Uncalled bet ($0.30) returned to Dealer
Dealer: doesn't show hand
Dealer collected $0.37 from pot
*** SUMMARY ***
Total pot $0.37 | Rake $0.00
Seat 1: Dealer (button) won ($0.37)
Seat 2: Small Blind (small blind) showed
Seat 3: Hero (big blind) showed
Seat 4: UTG showed
Seat 5: UTGplus1 showed
Seat 6: UTGplus2 showed



PokerStars Zoom Hand #3434278679: Hold'em No Limit ($0.02/$0.05) - 2017/03/08 21:00:41
Table '#952' 6-max Seat #3 is the button
Seat 1: UTGplus1 ($4.76 in chips)
Seat 2: Hero ($4.79 in chips)
Seat 3: Dealer ($5.05 in chips)
Seat 4: Small Blind ($6.39 in chips)
Seat 5: Big Blind ($2.50 in chips)
Seat 6: UTG ($6.92 in chips)
Small Blind: posts small blind $0.02
Big Blind: posts big blind $0.05
*** HOLE CARDS ***
Dealt to Hero [8h 7c]
UTG: folds
UTGplus1: folds
Hero: raises $0.17 to $0.17
Dealer: folds
Small Blind: folds
Big Blind: calls $0.12 
*** FLOP *** [3c Td 7h]
Big Blind: checks
Hero: bets $0.23 
Big Blind: calls $0.23 
*** TURN *** [3c Td 7h] [2h]
Big Blind: checks
Hero: checks
*** RIVER *** [3c Td 7h 2h] [6s]
Big Blind: bets $0.54 
Hero: calls $0.54 
*** SHOW DOWN ***
Big Blind: shows [Tc Ts] (three of a kind, Tens)
Hero: shows [8h 7c] (One pair)
Big Blind collected $1.81 from pot
*** SUMMARY ***
Total pot $1.9 | Rake $0.09
Board [3c Td 7h 2h 6s]
Seat 1: UTGplus1 showed
Seat 2: Hero showed [8h 7c]
Seat 3: Dealer (button) showed
Seat 4: Small Blind (small blind) showed
Seat 5: Big Blind (big blind) showed [Tc Ts] and won ($1.81) with three of a kind, Tens
Seat 6: UTG showed



PokerStars Zoom Hand #3434279054: Hold'em No Limit ($0.02/$0.05) - 2017/03/08 21:01:30
Table '#952' 6-max Seat #5 is the button
Seat 1: Big Blind ($9.42 in chips)
Seat 2: UTG ($5.53 in chips)
Seat 3: Hero ($3.85 in chips)
Seat 4: UTGplus2 ($3.37 in chips)
Seat 5: Dealer ($6.42 in chips)
Seat 6: Small Blind ($2.43 in chips)
Small Blind: posts small blind $0.02
Big Blind: posts big blind $0.05
*** HOLE CARDS ***
Dealt to Hero [Ah Kc]
UTG: folds
Hero: raises $0.17 to $0.17
UTGplus2: folds
Dealer: folds
Small Blind: folds
Big Blind: folds
Uncalled bet ($0.12) returned to Hero
Hero: doesn't show hand
Hero collected $0.12 from pot
*** SUMMARY ***
Total pot $0.12 | Rake $0.00
Seat 1: Big Blind (big blind) showed
Seat 2: UTG showed
Seat 3: Hero won ($0.12)
Seat 4: UTGplus2 showed
Seat 5: Dealer (button) showed
Seat 6: Small Blind (small blind) showed



PokerStars Zoom Hand #3434279220: Hold'em No Limit ($0.02/$0.05) - 2017/03/08 21:01:50
Table '#952' 6-max Seat #6 is the button
Seat 1: Small Blind ($3.64 in chips)
Seat 2: Big Blind ($10.31 in chips)
Seat 3: Hero ($3.92 in chips)
Seat 4: UTGplus1 ($5.02 in chips)
Seat 5: UTGplus2 ($5.84 in chips)
Seat 6: Dealer ($3.27 in chips)
Small Blind: posts small blind $0.02
Big Blind: posts big blind $0.05
*** HOLE CARDS ***
Dealt to Hero [Js Ks]
Hero: raises $0.17 to $0.17
UTGplus1: folds
UTGplus2: folds
Dealer: folds
Small Blind: raises $0.42 to $0.44
Big Blind: folds
Hero: calls $0.27 
*** FLOP *** [Kd Kh Qh]
Small Blind: checks
Hero: bets $0.56 
Small Blind: calls $0.56 
*** TURN *** [Kd Kh Qh] [3h]
Small Blind: checks
Hero: bets $1.02 
Small Blind: calls $1.02 
*** RIVER *** [Kd Kh Qh 3h] [8s]
Small Blind: bets $1.62 and is all-in
Hero: calls $1.62 
*** SHOW DOWN ***
Small Blind: shows [Kc Ah] (three of a kind, Kings)
Hero: shows [Js Ks] (Three of a kind)
Small Blind collected $6.97 from pot
*** SUMMARY ***
Total pot $7.33 | Rake $0.36
Board [Kd Kh Qh 3h 8s]
Seat 1: Small Blind (small blind) showed [Kc Ah] and won ($6.97) with three of a kind, Kings
Seat 2: Big Blind (big blind) showed
Seat 3: Hero showed [Js Ks]
Seat 4: UTGplus1 showed
Seat 5: UTGplus2 showed
Seat 6: Dealer (button) showed



PokerStars Zoom Hand #3434279910: Hold'em No Limit ($0.02/$0.05) - 2017/03/08 21:03:15
Table '#952' 6-max Seat #5 is the button
Seat 1: Big Blind ($6.07 in chips)
Seat 2: UTG ($6.97 in chips)
Seat 3: Hero ($0.28 in chips)
Seat 4: UTGplus2 ($12.40 in chips)
Seat 5: Dealer ($5.37 in chips)
Seat 6: Small Blind ($1.52 in chips)
Small Blind: posts small blind $0.02
Big Blind: posts big blind $0.05
*** HOLE CARDS ***
Dealt to Hero [6c Qs]
UTG: folds
Hero: folds
UTGplus2: raises $0.15 to $0.15
Dealer: folds
Small Blind: folds
Big Blind: folds
Uncalled bet ($0.10) returned to UTGplus2
UTGplus2: doesn't show hand
UTGplus2 collected $0.12 from pot
Table leave user
*** SUMMARY ***
Total pot $0.12 | Rake $0.00
Seat 1: Big Blind (big blind) showed
Seat 2: UTG showed
Seat 3: Hero showed
Seat 4: UTGplus2 won ($0.12)
Seat 5: Dealer (button) showed
Seat 6: Small Blind (small blind) showed



PokerStars Zoom Hand #3434279977: Hold'em No Limit ($0.02/$0.05) - 2017/03/08 21:03:24
Table '#952' 6-max Seat #3 is the button
Seat 1: UTGplus1 ($4.78 in chips)
Seat 2: UTGplus2 ($7.51 in chips)
Seat 3: Dealer ($5.77 in chips)
Seat 4: Small Blind ($3.04 in chips)
Seat 5: Hero ($5 in chips)
Seat 6: UTG ($6.97 in chips)
Small Blind: posts small blind $0.02
Hero: posts big blind $0.05
*** HOLE CARDS ***
Dealt to Hero [Tc 7h]
UTG: folds
UTGplus1: raises $0.15 to $0.15
UTGplus2: folds
Dealer: folds
Small Blind: folds
Hero: folds
Uncalled bet ($0.10) returned to UTGplus1
UTGplus1: doesn't show hand
UTGplus1 collected $0.12 from pot
*** SUMMARY ***
Total pot $0.12 | Rake $0.00
Seat 1: UTGplus1 won ($0.12)
Seat 2: UTGplus2 showed
Seat 3: Dealer (button) showed
Seat 4: Small Blind (small blind) showed
Seat 5: Hero (big blind) showed
Seat 6: UTG showed



PokerStars Zoom Hand #3434280158: Hold'em No Limit ($0.02/$0.05) - 2017/03/08 21:03:46
Table '#952' 6-max Seat #2 is the button
Seat 1: UTGplus2 ($2.54 in chips)
Seat 2: Dealer ($12.47 in chips)
Seat 3: Small Blind ($3.34 in chips)
Seat 4: Big Blind ($5.77 in chips)
Seat 5: Hero ($4.95 in chips)
Seat 6: UTGplus1 ($4.38 in chips)
Small Blind: posts small blind $0.02
Big Blind: posts big blind $0.05
*** HOLE CARDS ***
Dealt to Hero [Td 3s]
Hero: folds
UTGplus1: folds
UTGplus2: folds
Dealer: folds
Small Blind: calls $0.03 
Big Blind: checks
*** FLOP *** [Ah Jd 4d]
Small Blind: bets $0.05 
Big Blind: calls $0.05 
*** TURN *** [Ah Jd 4d] [Kd]
Small Blind: bets $0.20 
Big Blind: calls $0.20 
*** RIVER *** [Ah Jd 4d Kd] [Ad]
Small Blind: checks
Big Blind: checks
*** SHOW DOWN ***
Small Blind: shows [Kh Js] (two pair, Aces and Jacks)
Big Blind: shows [5d Jc] (a flush, Ace high)
Big Blind collected $0.57 from pot
*** SUMMARY ***
Total pot $0.6 | Rake $0.03
Board [Ah Jd 4d Kd Ad]
Seat 1: UTGplus2 showed
Seat 2: Dealer (button) showed
Seat 3: Small Blind (small blind) showed [Kh Js] and lost with two pair, Aces and Jacks
Seat 4: Big Blind (big blind) showed [5d Jc] and won ($0.57) with a flush, Ace high
Seat 5: Hero showed
Seat 6: UTGplus1 showed



PokerStars Zoom Hand #3434280200: Hold'em No Limit ($0.02/$0.05) - 2017/03/08 21:03:51
Table '#952' 6-max Seat #3 is the button
Seat 1: UTGplus1 ($7.57 in chips)
Seat 2: Hero ($4.95 in chips)
Seat 3: Dealer ($4.85 in chips)
Seat 4: Small Blind ($22.70 in chips)
Seat 5: Big Blind ($6.90 in chips)
Seat 6: UTG ($3 in chips)
Small Blind: posts small blind $0.02
Big Blind: posts big blind $0.05
*** HOLE CARDS ***
Dealt to Hero [3h Td]
UTG: folds
UTGplus1: folds
Hero: folds
Dealer: folds
Small Blind: raises $0.08 to $0.10
Big Blind: raises $0.25 to $0.30
Small Blind: raises $22.40 to $22.70 and is all-in
Big Blind: folds
Uncalled bet ($22.40) returned to Small Blind
Small Blind: doesn't show hand
Small Blind collected $0.6 from pot
*** SUMMARY ***
Total pot $0.6 | Rake $0.00
Seat 1: UTGplus1 showed
Seat 2: Hero showed
Seat 3: Dealer (button) showed
Seat 4: Small Blind (small blind) won ($0.6)
Seat 5: Big Blind (big blind) showed
Seat 6: UTG showed



PokerStars Zoom Hand #3434280236: Hold'em No Limit ($0.02/$0.05) - 2017/03/08 21:03:56
Table '#952' 6-max Seat #3 is the button
Seat 1: Hero ($4.95 in chips)
Seat 2: UTGplus2 ($3.21 in chips)
Seat 3: Dealer ($4.94 in chips)
Seat 4: Small Blind ($1.83 in chips)
Seat 5: Big Blind ($2.11 in chips)
Seat 6: UTG ($4.85 in chips)
Small Blind: posts small blind $0.02
Big Blind: posts big blind $0.05
*** HOLE CARDS ***
Dealt to Hero [8h 9h]
UTG: folds
Hero: raises $0.17 to $0.17
UTGplus2: folds
Dealer: folds
Small Blind: folds
Big Blind: folds
Uncalled bet ($0.12) returned to Hero
Hero: doesn't show hand
Hero collected $0.12 from pot
*** SUMMARY ***
Total pot $0.12 | Rake $0.00
Seat 1: Hero won ($0.12)
Seat 2: UTGplus2 showed
Seat 3: Dealer (button) showed
Seat 4: Small Blind (small blind) showed
Seat 5: Big Blind (big blind) showed
Seat 6: UTG showed



PokerStars Zoom Hand #3434280460: Hold'em No Limit ($0.02/$0.05) - 2017/03/08 21:04:25
Table '#952' 6-max Seat #4 is the button
Seat 1: UTG ($6.88 in chips)
Seat 2: Hero ($5.02 in chips)
Seat 3: UTGplus2 ($5 in chips)
Seat 4: Dealer ($5.03 in chips)
Seat 5: Small Blind ($2.45 in chips)
Seat 6: Big Blind ($7.41 in chips)
Small Blind: posts small blind $0.02
Big Blind: posts big blind $0.05
*** HOLE CARDS ***
Dealt to Hero [Qs As]
UTG: folds
Hero: raises $0.17 to $0.17
UTGplus2: folds
Dealer: folds
Small Blind: folds
Big Blind: folds
Uncalled bet ($0.12) returned to Hero
Hero: doesn't show hand
Hero collected $0.12 from pot
*** SUMMARY ***
Total pot $0.12 | Rake $0.00
Seat 1: UTG showed
Seat 2: Hero won ($0.12)
Seat 3: UTGplus2 showed
Seat 4: Dealer (button) showed
Seat 5: Small Blind (small blind) showed
Seat 6: Big Blind (big blind) showed



PokerStars Zoom Hand #3434280628: Hold'em No Limit ($0.02/$0.05) - 2017/03/08 21:04:44
Table '#952' 6-max Seat #1 is the button
Seat 1: Dealer ($7.36 in chips)
Seat 2: Small Blind ($5.81 in chips)
Seat 3: Big Blind ($3.33 in chips)
Seat 4: UTG ($3.59 in chips)
Seat 5: Hero ($5.09 in chips)
Seat 6: UTGplus2 ($4.72 in chips)
Small Blind: posts small blind $0.02
Big Blind: posts big blind $0.05
*** HOLE CARDS ***
Dealt to Hero [7c 2d]
UTG: folds
Hero: folds
UTGplus2: folds
Dealer: folds
Small Blind: raises $0.13 to $0.15
Big Blind: folds
Uncalled bet ($0.10) returned to Small Blind
Small Blind: doesn't show hand
Small Blind collected $0.1 from pot
*** SUMMARY ***
Total pot $0.1 | Rake $0.00
Seat 1: Dealer (button) showed
Seat 2: Small Blind (small blind) won ($0.1)
Seat 3: Big Blind (big blind) showed
Seat 4: UTG showed
Seat 5: Hero showed
Seat 6: UTGplus2 showed



PokerStars Zoom Hand #3434280667: Hold'em No Limit ($0.02/$0.05) - 2017/03/08 21:04:50
Table '#952' 6-max Seat #4 is the button
Seat 1: Hero ($5.09 in chips)
Seat 2: UTGplus1 ($2.72 in chips)
Seat 3: UTGplus2 ($3.35 in chips)
Seat 4: Dealer ($12.34 in chips)
Seat 5: Small Blind ($2.77 in chips)
Seat 6: Big Blind ($4.78 in chips)
Small Blind: posts small blind $0.02
Big Blind: posts big blind $0.05
*** HOLE CARDS ***
Dealt to Hero [9d Jc]
Hero: folds
UTGplus1: raises $0.10 to $0.10
UTGplus2: folds
Dealer: folds
Small Blind: folds
Big Blind: folds
Uncalled bet ($0.05) returned to UTGplus1
UTGplus1: doesn't show hand
UTGplus1 collected $0.12 from pot
*** SUMMARY ***
Total pot $0.12 | Rake $0.00
Seat 1: Hero showed
Seat 2: UTGplus1 won ($0.12)
Seat 3: UTGplus2 showed
Seat 4: Dealer (button) showed
Seat 5: Small Blind (small blind) showed
Seat 6: Big Blind (big blind) showed



PokerStars Zoom Hand #3434280710: Hold'em No Limit ($0.02/$0.05) - 2017/03/08 21:04:55
Table '#952' 6-max Seat #2 is the button
Seat 1: UTGplus2 ($3.35 in chips)
Seat 2: Dealer ($2.75 in chips)
Seat 3: Small Blind ($5.18 in chips)
Seat 4: Hero ($5.09 in chips)
Seat 5: UTG ($3.38 in chips)
Seat 6: UTGplus1 ($4.23 in chips)
Small Blind: posts small blind $0.02
Hero: posts big blind $0.05
*** HOLE CARDS ***
Dealt to Hero [6s 4d]
UTG: folds
UTGplus1: folds
UTGplus2: folds
Dealer: folds
Small Blind: folds
*** SHOW DOWN ***
Hero: shows [6s 4d] (high card Six)
Hero collected $0.07 from pot
*** SUMMARY ***
Total pot $0.07 | Rake $0.00
Seat 1: UTGplus2 showed
Seat 2: Dealer (button) showed
Seat 3: Small Blind (small blind) showed
Seat 4: Hero (big blind) collected $0.02
Seat 5: UTG showed
Seat 6: UTGplus1 showed



PokerStars Zoom Hand #3434280751: Hold'em No Limit ($0.02/$0.05) - 2017/03/08 21:04:59
Table '#952' 6-max Seat #5 is the button
Seat 1: Big Blind ($3.38 in chips)
Seat 2: UTG ($2.42 in chips)
Seat 3: UTGplus1 ($4.89 in chips)
Seat 4: Hero ($5.04 in chips)
Seat 5: Dealer ($7.06 in chips)
Seat 6: Small Blind ($2.95 in chips)
Small Blind: posts small blind $0.02
Big Blind: posts big blind $0.05
*** HOLE CARDS ***
Dealt to Hero [Jd Jc]
UTG: folds
UTGplus1: folds
Hero: raises $0.17 to $0.17
Dealer: folds
Small Blind: folds
Big Blind: folds
Uncalled bet ($0.12) returned to Hero
Hero: doesn't show hand
Hero collected $0.12 from pot
*** SUMMARY ***
Total pot $0.12 | Rake $0.00
Seat 1: Big Blind (big blind) showed
Seat 2: UTG showed
Seat 3: UTGplus1 showed
Seat 4: Hero won ($0.12)
Seat 5: Dealer (button) showed
Seat 6: Small Blind (small blind) showed



PokerStars Zoom Hand #3434280931: Hold'em No Limit ($0.02/$0.05) - 2017/03/08 21:05:24
Table '#952' 6-max Seat #3 is the button
Seat 1: UTGplus1 ($4.83 in chips)
Seat 2: UTGplus2 ($23.46 in chips)
Seat 3: Hero ($5.18 in chips)
Seat 4: Small Blind ($3.30 in chips)
Seat 5: Big Blind ($9.63 in chips)
Seat 6: UTG ($1.41 in chips)
Small Blind: posts small blind $0.02
Big Blind: posts big blind $0.05
*** HOLE CARDS ***
Dealt to Hero [Jh 7h]
UTG: folds
UTGplus1: folds
UTGplus2: folds
Hero: raises $0.17 to $0.17
Small Blind: calls $0.15 
Big Blind: folds
*** FLOP *** [5d Kh Th]
Small Blind: checks
Hero: bets $0.25 
Small Blind: folds
Uncalled bet ($0.25) returned to Hero
Hero: doesn't show hand
Hero collected $0.38 from pot
Table leave user
*** SUMMARY ***
Total pot $0.39 | Rake $0.01
Board [5d Kh Th]
Seat 1: UTGplus1 showed
Seat 2: UTGplus2 showed
Seat 3: Hero (button) won ($0.38)
Seat 4: Small Blind (small blind) showed
Seat 5: Big Blind (big blind) showed
Seat 6: UTG showed



PokerStars Zoom Hand #3434281323: Hold'em No Limit ($0.02/$0.05) - 2017/03/08 21:06:14
Table '#952' 6-max Seat #3 is the button
Seat 1: UTGplus1 ($5.32 in chips)
Seat 2: Hero ($5.39 in chips)
Seat 3: Dealer ($1.22 in chips)
Seat 4: Small Blind ($5.18 in chips)
Seat 5: Big Blind ($4.53 in chips)
Seat 6: UTG ($6.57 in chips)
Small Blind: posts small blind $0.02
Big Blind: posts big blind $0.05
*** HOLE CARDS ***
Dealt to Hero [4d Jc]
UTG: folds
UTGplus1: folds
Hero: folds
Dealer: folds
Small Blind: raises $0.13 to $0.15
Big Blind: raises $0.25 to $0.30
Small Blind: calls $0.15 
*** FLOP *** [7c Kd Qh]
Small Blind: checks
Big Blind: bets $0.30 
Small Blind: calls $0.30 
*** TURN *** [7c Kd Qh] [Jh]
Small Blind: checks
Big Blind: bets $0.70 
Small Blind: calls $0.70 
*** RIVER *** [7c Kd Qh Jh] [Th]
Small Blind: checks
Big Blind: bets $0.94 
Small Blind: calls $0.94 
*** SHOW DOWN ***
Big Blind: shows [Tc As] (a straight, Ten to Ace)
Small Blind: shows [Qc Kc] (Two pair)
Big Blind collected $4.26 from pot
*** SUMMARY ***
Total pot $4.48 | Rake $0.22
Board [7c Kd Qh Jh Th]
Seat 1: UTGplus1 showed
Seat 2: Hero showed
Seat 3: Dealer (button) showed
Seat 4: Small Blind (small blind) showed [Qc Kc]
Seat 5: Big Blind (big blind) showed [Tc As] and won ($4.26) with a straight, Ten to Ace
Seat 6: UTG showed



PokerStars Zoom Hand #3434281372: Hold'em No Limit ($0.02/$0.05) - 2017/03/08 21:06:20
Table '#952' 6-max Seat #5 is the button
Seat 1: Big Blind ($1.22 in chips)
Seat 2: Hero ($5.39 in chips)
Seat 3: UTGplus1 ($6.57 in chips)
Seat 4: UTGplus2 ($2.27 in chips)
Seat 5: Dealer ($9.94 in chips)
Seat 6: Small Blind ($3.07 in chips)
Small Blind: posts small blind $0.02
Big Blind: posts big blind $0.05
*** HOLE CARDS ***
Dealt to Hero [3s 9h]
Hero: folds
UTGplus1: raises $0.10 to $0.10
UTGplus2: calls $0.10 
Dealer: calls $0.10 
Small Blind: calls $0.08 
Big Blind: folds
*** FLOP *** [7s Kd 8s]
Small Blind: checks
UTGplus1: checks
UTGplus2: checks
Dealer: checks
*** TURN *** [7s Kd 8s] [4h]
Small Blind: checks
UTGplus1: checks
UTGplus2: checks
Dealer: checks
*** RIVER *** [7s Kd 8s 4h] [4s]
Small Blind: checks
UTGplus1: checks
UTGplus2: bets $0.20 
Dealer: folds
Small Blind: folds
UTGplus1: folds
Uncalled bet ($0.20) returned to UTGplus2
UTGplus2: doesn't show hand
UTGplus2 collected $0.43 from pot
*** SUMMARY ***
Total pot $0.45 | Rake $0.02
Board [7s Kd 8s 4h 4s]
Seat 1: Big Blind (big blind) showed
Seat 2: Hero showed
Seat 3: UTGplus1 showed
Seat 4: UTGplus2 won ($0.43)
Seat 5: Dealer (button) showed
Seat 6: Small Blind (small blind) showed



PokerStars Zoom Hand #3434281416: Hold'em No Limit ($0.02/$0.05) - 2017/03/08 21:06:25
Table '#952' 6-max Seat #3 is the button
Seat 1: UTGplus1 ($5.19 in chips)
Seat 2: UTGplus2 ($4.08 in chips)
Seat 3: Dealer ($4.73 in chips)
Seat 4: Hero ($5.39 in chips)
Seat 5: Big Blind ($10.84 in chips)
Seat 6: UTG ($1.17 in chips)
Hero: posts small blind $0.02
Big Blind: posts big blind $0.05
*** HOLE CARDS ***
Dealt to Hero [Ks As]
UTG: folds
UTGplus1: folds
UTGplus2: folds
Dealer: raises $0.10 to $0.10
Hero: raises $0.33 to $0.35
Big Blind: folds
Dealer: folds
Uncalled bet ($0.25) returned to Hero
Hero: doesn't show hand
Hero collected $0.25 from pot
*** SUMMARY ***
Total pot $0.25 | Rake $0.00
Seat 1: UTGplus1 showed
Seat 2: UTGplus2 showed
Seat 3: Dealer (button) showed
Seat 4: Hero (small blind) won ($0.25)
Seat 5: Big Blind (big blind) showed
Seat 6: UTG showed



PokerStars Zoom Hand #3434281584: Hold'em No Limit ($0.02/$0.05) - 2017/03/08 21:06:49
Table '#952' 6-max Seat #3 is the button
Seat 1: UTGplus1 ($5.81 in chips)
Seat 2: UTGplus2 ($10.18 in chips)
Seat 3: Dealer ($6.73 in chips)
Seat 4: Small Blind ($14.01 in chips)
Seat 5: Hero ($5.54 in chips)
Seat 6: UTG ($4.87 in chips)
Small Blind: posts small blind $0.02
Hero: posts big blind $0.05
*** HOLE CARDS ***
Dealt to Hero [3s 9c]
UTG: folds
UTGplus1: raises $0.15 to $0.15
UTGplus2: folds
Dealer: folds
Small Blind: folds
Hero: folds
Uncalled bet ($0.10) returned to UTGplus1
UTGplus1: doesn't show hand
UTGplus1 collected $0.12 from pot
*** SUMMARY ***
Total pot $0.12 | Rake $0.00
Seat 1: UTGplus1 won ($0.12)
Seat 2: UTGplus2 showed
Seat 3: Dealer (button) showed
Seat 4: Small Blind (small blind) showed
Seat 5: Hero (big blind) showed
Seat 6: UTG showed



PokerStars Zoom Hand #3434281699: Hold'em No Limit ($0.02/$0.05) - 2017/03/08 21:07:03
Table '#952' 6-max Seat #2 is the button
Seat 1: UTGplus2 ($2.27 in chips)
Seat 2: Dealer ($11.06 in chips)
Seat 3: Small Blind ($4.80 in chips)
Seat 4: Big Blind ($6.71 in chips)
Seat 5: Hero ($5.49 in chips)
Seat 6: UTGplus1 ($6.87 in chips)
Small Blind: posts small blind $0.02
Big Blind: posts big blind $0.05
*** HOLE CARDS ***
Dealt to Hero [Js Kh]
Hero: raises $0.17 to $0.17
UTGplus1: folds
UTGplus2: folds
Dealer: calls $0.17 
Small Blind: folds
Big Blind: folds
*** FLOP *** [Jh 8c 5s]
Hero: bets $0.25 
Dealer: calls $0.25 
*** TURN *** [Jh 8c 5s] [7c]
Hero: bets $0.55 
Dealer: raises $1.20 to $1.20
Hero: calls $0.65 
*** RIVER *** [Jh 8c 5s 7c] [7d]
Hero: checks
Dealer: checks
*** SHOW DOWN ***
Hero: shows [Js Kh] (two pair, Jacks and Kings)
Dealer: shows [Jc Tc] (Two pair)
Hero collected $3.15 from pot
*** SUMMARY ***
Total pot $3.31 | Rake $0.16
Board [Jh 8c 5s 7c 7d]
Seat 1: UTGplus2 showed
Seat 2: Dealer (button) showed [Jc Tc]
Seat 3: Small Blind (small blind) showed
Seat 4: Big Blind (big blind) showed
Seat 5: Hero showed [Js Kh] and won ($3.15) with two pair, Jacks and Kings
Seat 6: UTGplus1 showed



PokerStars Zoom Hand #3434282244: Hold'em No Limit ($0.02/$0.05) - 2017/03/08 21:08:11
Table '#952' 6-max Seat #2 is the button
Seat 1: UTGplus2 ($6.26 in chips)
Seat 2: Dealer ($7.38 in chips)
Seat 3: Small Blind ($16.22 in chips)
Seat 4: Big Blind ($12.46 in chips)
Seat 5: UTG ($9.44 in chips)
Seat 6: Hero ($7.02 in chips)
Small Blind: posts small blind $0.02
Big Blind: posts big blind $0.05
*** HOLE CARDS ***
Dealt to Hero [4s 9s]
UTG: folds
Hero: folds
UTGplus2: folds
Dealer: folds
Small Blind: calls $0.03 
Big Blind: checks
*** FLOP *** [Ac 8d Tc]
Small Blind: checks
Big Blind: checks
*** TURN *** [Ac 8d Tc] [Jd]
Small Blind: checks
Big Blind: checks
*** RIVER *** [Ac 8d Tc Jd] [8h]
Small Blind: checks
Big Blind: bets $0.10 
Small Blind: calls $0.10 
*** SHOW DOWN ***
Big Blind: shows [6h 8s] (three of a kind, Eights)
Small Blind: shows [Kd 7s] (One pair)
Big Blind collected $0.29 from pot
*** SUMMARY ***
Total pot $0.3 | Rake $0.01
Board [Ac 8d Tc Jd 8h]
Seat 1: UTGplus2 showed
Seat 2: Dealer (button) showed
Seat 3: Small Blind (small blind) showed [Kd 7s]
Seat 4: Big Blind (big blind) showed [6h 8s] and won ($0.29) with three of a kind, Eights
Seat 5: UTG showed
Seat 6: Hero showed



PokerStars Zoom Hand #3434282633: Hold'em No Limit ($0.02/$0.05) - 2017/03/08 21:08:58
Table '#952' 6-max Seat #6 is the button
Seat 1: Hero ($7.02 in chips)
Seat 2: Big Blind ($14.02 in chips)
Seat 3: UTG ($3.43 in chips)
Seat 4: UTGplus1 ($4.95 in chips)
Seat 5: UTGplus2 ($8.54 in chips)
Seat 6: Dealer ($5.29 in chips)
Hero: posts small blind $0.02
Big Blind: posts big blind $0.05
*** HOLE CARDS ***
Dealt to Hero [5d 5c]
UTG: folds
UTGplus1: raises $0.15 to $0.15
UTGplus2: folds
Dealer: calls $0.15 
Hero: calls $0.13 
Big Blind: calls $0.10 
*** FLOP *** [3d Ks 5s]
Hero: checks
Big Blind: checks
UTGplus1: bets $0.30 
Dealer: folds
Hero: calls $0.30 
Big Blind: folds
*** TURN *** [3d Ks 5s] [6s]
Hero: checks
UTGplus1: checks
*** RIVER *** [3d Ks 5s 6s] [7d]
Hero: checks
UTGplus1: checks
*** SHOW DOWN ***
Hero: shows [5d 5c] (three of a kind, Fives)
UTGplus1: shows [Qc Ad] (High Card)
Hero collected $1.14 from pot
*** SUMMARY ***
Total pot $1.2 | Rake $0.06
Board [3d Ks 5s 6s 7d]
Seat 1: Hero (small blind) showed [5d 5c] and won ($1.14) with three of a kind, Fives
Seat 2: Big Blind (big blind) showed
Seat 3: UTG showed
Seat 4: UTGplus1 showed [Qc Ad]
Seat 5: UTGplus2 showed
Seat 6: Dealer (button) showed



PokerStars Zoom Hand #3434283139: Hold'em No Limit ($0.02/$0.05) - 2017/03/08 21:09:59
Table '#952' 6-max Seat #6 is the button
Seat 1: Small Blind ($4.23 in chips)
Seat 2: Hero ($7.71 in chips)
Seat 3: UTG ($4.50 in chips)
Seat 4: UTGplus1 ($14.07 in chips)
Seat 5: UTGplus2 ($2.43 in chips)
Seat 6: Dealer ($4.26 in chips)
Small Blind: posts small blind $0.02
Hero: posts big blind $0.05
*** HOLE CARDS ***
Dealt to Hero [Jh 2s]
UTG: raises $0.15 to $0.15
UTGplus1: folds
UTGplus2: folds
Dealer: folds
Small Blind: folds
UTGplus2: Table leave user
Hero: folds
Uncalled bet ($0.10) returned to UTG
UTG: doesn't show hand
UTG collected $0.12 from pot
*** SUMMARY ***
Total pot $0.12 | Rake $0.00
Seat 1: Small Blind (small blind) showed
Seat 2: Hero (big blind) showed
Seat 3: UTG won ($0.12)
Seat 4: UTGplus1 showed
Seat 5: UTGplus2 showed
Seat 6: Dealer (button) showed



PokerStars Zoom Hand #3434283291: Hold'em No Limit ($0.02/$0.05) - 2017/03/08 21:10:18
Table '#952' 6-max Seat #5 is the button
Seat 1: Big Blind ($2.86 in chips)
Seat 2: UTG ($9.72 in chips)
Seat 3: UTGplus1 ($8.37 in chips)
Seat 4: Hero ($7.66 in chips)
Seat 5: Dealer ($12.80 in chips)
Seat 6: Small Blind ($4.51 in chips)
Small Blind: posts small blind $0.02
Big Blind: posts big blind $0.05
*** HOLE CARDS ***
Dealt to Hero [Jh Js]
UTG: folds
UTGplus1: raises $0.15 to $0.15
Hero: raises $0.52 to $0.52
Dealer: folds
Small Blind: calls $0.50 
Big Blind: folds
UTGplus1: calls $0.37 
*** FLOP *** [9s 9d 5h]
Small Blind: bets $0.20 
UTGplus1: folds
Hero: calls $0.20 
*** TURN *** [9s 9d 5h] [Qs]
Small Blind: bets $0.20 
Hero: calls $0.20 
*** RIVER *** [9s 9d 5h Qs] [Ah]
Small Blind: bets $0.50 
Hero: calls $0.50 
*** SHOW DOWN ***
Small Blind: shows [8h Kc] (a pair of Nines)
Hero: shows [Jh Js] (two pair, Jacks and Aces)
Hero collected $3.24 from pot
*** SUMMARY ***
Total pot $3.41 | Rake $0.17
Board [9s 9d 5h Qs Ah]
Seat 1: Big Blind (big blind) showed
Seat 2: UTG showed
Seat 3: UTGplus1 showed
Seat 4: Hero showed [Jh Js] and won ($3.24) with two pair, Jacks and Aces
Seat 5: Dealer (button) showed
Seat 6: Small Blind (small blind) showed [8h Kc] and lost with a pair of Nines



PokerStars Zoom Hand #3434283777: Hold'em No Limit ($0.02/$0.05) - 2017/03/08 21:11:19
Table '#952' 6-max Seat #2 is the button
Seat 1: UTGplus2 ($4.02 in chips)
Seat 2: Dealer ($12.69 in chips)
Seat 3: Hero ($9.48 in chips)
Seat 4: Big Blind ($3.09 in chips)
Seat 5: UTG ($0.43 in chips)
Seat 6: UTGplus1 ($4.95 in chips)
Hero: posts small blind $0.02
Big Blind: posts big blind $0.05
*** HOLE CARDS ***
Dealt to Hero [3s Kd]
UTG: folds
UTGplus1: folds
UTGplus2: folds
Dealer: folds
Hero: folds
*** SHOW DOWN ***
Big Blind: shows [2s As] (high card Deuce)
Big Blind collected $0.07 from pot
*** SUMMARY ***
Total pot $0.07 | Rake $0.00
Seat 1: UTGplus2 showed
Seat 2: Dealer (button) showed
Seat 3: Hero (small blind) showed
Seat 4: Big Blind (big blind) collected $0.02
Seat 5: UTG showed
Seat 6: UTGplus1 showed



PokerStars Zoom Hand #3434283832: Hold'em No Limit ($0.02/$0.05) - 2017/03/08 21:11:26
Table '#952' 6-max Seat #5 is the button
Seat 1: Big Blind ($2.50 in chips)
Seat 2: Hero ($9.46 in chips)
Seat 3: UTGplus1 ($6.55 in chips)
Seat 4: UTGplus2 ($3.86 in chips)
Seat 5: Dealer ($4.55 in chips)
Seat 6: Small Blind ($1.52 in chips)
Small Blind: posts small blind $0.02
Big Blind: posts big blind $0.05
*** HOLE CARDS ***
Dealt to Hero [8s Ks]
Hero: folds
UTGplus1: raises $0.15 to $0.15
UTGplus2: folds
Dealer: folds
Small Blind: folds
Big Blind: folds
Uncalled bet ($0.10) returned to UTGplus1
UTGplus1: doesn't show hand
UTGplus1 collected $0.12 from pot
Seat re-join
*** SUMMARY ***
Total pot $0.12 | Rake $0.00
Seat 1: Big Blind (big blind) showed
Seat 2: Hero showed
Seat 3: UTGplus1 won ($0.12)
Seat 4: UTGplus2 showed
Seat 5: Dealer (button) showed
Seat 6: Small Blind (small blind) showed



PokerStars Zoom Hand #3434283886: Hold'em No Limit ($0.02/$0.05) - 2017/03/08 21:11:34
Table '#952' 6-max Seat #1 is the button
Seat 1: Dealer ($7.96 in chips)
Seat 2: Hero ($9.46 in chips)
Seat 3: Big Blind ($5.63 in chips)
Seat 4: UTG ($1.50 in chips)
Seat 5: UTGplus1 ($3.11 in chips)
Seat 6: UTGplus2 ($4.44 in chips)
Hero: posts small blind $0.02
Big Blind: posts big blind $0.05
*** HOLE CARDS ***
Dealt to Hero [4s 2s]
UTG: folds
UTGplus1: raises $0.20 to $0.20
UTGplus2: folds
Dealer: folds
Hero: folds
Big Blind: folds
*** SHOW DOWN ***
UTGplus1: shows [8h 4h] (high card Eight)
Uncalled bet ($0.15) returned to UTGplus1
UTGplus1 collected $0.12 from pot
*** SUMMARY ***
Total pot $0.12 | Rake $0.00
Seat 1: Dealer (button) showed
Seat 2: Hero (small blind) showed
Seat 3: Big Blind (big blind) showed
Seat 4: UTG showed
Seat 5: UTGplus1 collected ($0.12)
Seat 6: UTGplus2 showed



PokerStars Zoom Hand #3434284013: Hold'em No Limit ($0.02/$0.05) - 2017/03/08 21:11:49
Table '#952' 6-max Seat #5 is the button
Seat 1: Big Blind ($4.44 in chips)
Seat 2: UTG ($10.42 in chips)
Seat 3: UTGplus1 ($4.92 in chips)
Seat 4: UTGplus2 ($3.92 in chips)
Seat 5: Hero ($9.44 in chips)
Seat 6: Small Blind ($6.08 in chips)
Small Blind: posts small blind $0.02
Big Blind: posts big blind $0.05
*** HOLE CARDS ***
Dealt to Hero [Jh Tc]
UTG: folds
UTGplus1: folds
UTGplus2: calls $0.05 
Hero: raises $0.22 to $0.22
Small Blind: folds
Big Blind: folds
UTGplus2: calls $0.17 
*** FLOP *** [9c 8s 3s]
UTGplus2: checks
Hero: bets $0.35 
UTGplus2: calls $0.35 
*** TURN *** [9c 8s 3s] [9s]
UTGplus2: checks
Hero: checks
*** RIVER *** [9c 8s 3s 9s] [6d]
UTGplus2: checks
Hero: checks
*** SHOW DOWN ***
UTGplus2: shows [8h Qh] (two pair, Nines and Queens)
Hero: shows [Jh Tc] (One pair)
UTGplus2 collected $1.15 from pot
*** SUMMARY ***
Total pot $1.21 | Rake $0.06
Board [9c 8s 3s 9s 6d]
Seat 1: Big Blind (big blind) showed
Seat 2: UTG showed
Seat 3: UTGplus1 showed
Seat 4: UTGplus2 showed [8h Qh] and won ($1.15) with two pair, Nines and Queens
Seat 5: Hero (button) showed [Jh Tc]
Seat 6: Small Blind (small blind) showed



PokerStars Zoom Hand #3434284456: Hold'em No Limit ($0.02/$0.05) - 2017/03/08 21:12:41
Table '#952' 6-max Seat #2 is the button
Seat 1: UTGplus2 ($4.50 in chips)
Seat 2: Hero ($8.87 in chips)
Seat 3: Small Blind ($2.60 in chips)
Seat 4: Big Blind ($3.77 in chips)
Seat 5: UTG ($9 in chips)
Seat 6: UTGplus1 ($13.92 in chips)
Small Blind: posts small blind $0.02
Big Blind: posts big blind $0.05
*** HOLE CARDS ***
Dealt to Hero [3h Kd]
UTG: calls $0.05 
UTGplus1: raises $0.10 to $0.10
UTGplus2: calls $0.10 
Hero: folds
Small Blind: folds
Big Blind: folds
UTG: calls $0.05 
*** FLOP *** [5d 6d 7s]
UTG: checks
UTGplus1: checks
UTGplus2: bets $0.10 
UTG: calls $0.10 
UTGplus1: calls $0.10 
*** TURN *** [5d 6d 7s] [Js]
UTG: checks
UTGplus1: checks
UTGplus2: checks
*** RIVER *** [5d 6d 7s Js] [8h]
UTG: checks
UTGplus1: checks
UTGplus2: bets $0.15 
UTG: folds
UTGplus1: calls $0.15 
*** SHOW DOWN ***
UTGplus2: shows [Ah 4d] (a straight, Four to Eight)
UTGplus1: shows [As 5s] (One pair)
UTGplus2 collected $0.93 from pot
*** SUMMARY ***
Total pot $0.97 | Rake $0.04
Board [5d 6d 7s Js 8h]
Seat 1: UTGplus2 showed [Ah 4d] and won ($0.93) with a straight, Four to Eight
Seat 2: Hero (button) showed
Seat 3: Small Blind (small blind) showed
Seat 4: Big Blind (big blind) showed
Seat 5: UTG showed
Seat 6: UTGplus1 showed [As 5s]



PokerStars Zoom Hand #3434284490: Hold'em No Limit ($0.02/$0.05) - 2017/03/08 21:12:46
Table '#952' 6-max Seat #3 is the button
Seat 1: UTGplus1 ($2.77 in chips)
Seat 2: UTGplus2 ($6.28 in chips)
Seat 3: Dealer ($4.07 in chips)
Seat 4: Small Blind ($4.69 in chips)
Seat 5: Hero ($8.87 in chips)
Seat 6: UTG ($2.88 in chips)
Small Blind: posts small blind $0.02
Hero: posts big blind $0.05
*** HOLE CARDS ***
Dealt to Hero [2d As]
UTG: folds
UTGplus1: folds 
UTGplus2: raises $0.15 to $0.15
Dealer: folds
UTGplus1: Seat re-join
Small Blind: calls $0.13 
Hero: folds
*** FLOP *** [Jh 9h 6c]
Small Blind: checks
UTGplus2: bets $0.35 
Small Blind: folds
Uncalled bet ($0.35) returned to UTGplus2
UTGplus2: doesn't show hand
UTGplus2 collected $0.34 from pot
*** SUMMARY ***
Total pot $0.35 | Rake $0.01
Board [Jh 9h 6c]
Seat 1: UTGplus1 showed
Seat 2: UTGplus2 won ($0.34)
Seat 3: Dealer (button) showed
Seat 4: Small Blind (small blind) showed
Seat 5: Hero (big blind) showed
Seat 6: UTG showed



PokerStars Zoom Hand #3434284549: Hold'em No Limit ($0.02/$0.05) - 2017/03/08 21:12:53
Table '#952' 6-max Seat #5 is the button
Seat 1: Big Blind ($7.98 in chips)
Seat 2: Hero ($8.82 in chips)
Seat 3: UTGplus1 ($12.66 in chips)
Seat 4: UTGplus2 ($1.33 in chips)
Seat 5: Dealer ($4.33 in chips)
Seat 6: Small Blind ($5.24 in chips)
Small Blind: posts small blind $0.02
Big Blind: posts big blind $0.05
*** HOLE CARDS ***
Dealt to Hero [8s As]
Hero: folds
UTGplus1: folds
UTGplus2: folds
Dealer: raises $0.10 to $0.10
Small Blind: raises $0.28 to $0.30
Big Blind: raises $0.95 to $1
Dealer: folds
Small Blind: folds
Uncalled bet ($0.70) returned to Big Blind
Big Blind: doesn't show hand
Big Blind collected $0.7 from pot
Table deposit $0.24 
*** SUMMARY ***
Total pot $0.7 | Rake $0.00
Seat 1: Big Blind (big blind) won ($0.7)
Seat 2: Hero showed
Seat 3: UTGplus1 showed
Seat 4: UTGplus2 showed
Seat 5: Dealer (button) showed
Seat 6: Small Blind (small blind) showed



PokerStars Zoom Hand #3434284597: Hold'em No Limit ($0.02/$0.05) - 2017/03/08 21:12:59
Table '#952' 6-max Seat #4 is the button
Seat 1: UTG ($2.83 in chips)
Seat 2: UTGplus1 ($1.33 in chips)
Seat 3: UTGplus2 ($9.28 in chips)
Seat 4: Dealer ($12.86 in chips)
Seat 5: Hero ($8.82 in chips)
Seat 6: Big Blind ($4.07 in chips)
Hero: posts small blind $0.02
Big Blind: posts big blind $0.05
*** HOLE CARDS ***
Dealt to Hero [9h 5s]
UTG: folds
UTGplus1: folds
UTGplus2: raises $0.15 to $0.15
Dealer: calls $0.15 
Hero: folds
Big Blind: folds
*** FLOP *** [7h Jc 2s]
UTGplus2: bets $0.37 
Dealer: calls $0.37 
*** TURN *** [7h Jc 2s] [Jh]
UTGplus2: bets $0.55 
Dealer: calls $0.55 
*** RIVER *** [7h Jc 2s Jh] [5c]
UTGplus2: checks
Dealer: checks
*** SHOW DOWN ***
UTGplus2: shows [Kd Kh] (two pair, Kings and Sevens)
Dealer: shows [9s 9d] (Two pair)
UTGplus2 collected $2.1 from pot
Seat re-join
*** SUMMARY ***
Total pot $2.21 | Rake $0.11
Board [7h Jc 2s Jh 5c]
Seat 1: UTG showed
Seat 2: UTGplus1 showed
Seat 3: UTGplus2 showed [Kd Kh] and won ($2.1) with two pair, Kings and Sevens
Seat 4: Dealer (button) showed [9s 9d]
Seat 5: Hero (small blind) showed
Seat 6: Big Blind (big blind) showed



PokerStars Zoom Hand #3434284639: Hold'em No Limit ($0.02/$0.05) - 2017/03/08 21:13:04
Table '#952' 6-max Seat #1 is the button
Seat 1: Dealer ($10.70 in chips)
Seat 2: Hero ($8.80 in chips)
Seat 3: Big Blind ($2.98 in chips)
Seat 4: UTG ($15.47 in chips)
Seat 5: UTGplus1 ($4.66 in chips)
Seat 6: UTGplus2 ($7.86 in chips)
Hero: posts small blind $0.02
Big Blind: posts big blind $0.05
*** HOLE CARDS ***
Dealt to Hero [Jd 2d]
UTG: folds
UTGplus1: calls $0.05 
UTGplus2: folds
Dealer: folds
Hero: folds
Big Blind: checks
*** FLOP *** [Qh 5c Ah]
Big Blind: checks
UTGplus1: bets $0.11 
Big Blind: folds
Uncalled bet ($0.11) returned to UTGplus1
UTGplus1: doesn't show hand
UTGplus1 collected $0.12 from pot
Seat re-join
*** SUMMARY ***
Total pot $0.12 | Rake $0.00
Board [Qh 5c Ah]
Seat 1: Dealer (button) showed
Seat 2: Hero (small blind) showed
Seat 3: Big Blind (big blind) showed
Seat 4: UTG showed
Seat 5: UTGplus1 won ($0.12)
Seat 6: UTGplus2 showed



PokerStars Zoom Hand #3434284680: Hold'em No Limit ($0.02/$0.05) - 2017/03/08 21:13:09
Table '#952' 6-max Seat #6 is the button
Seat 1: Hero ($8.78 in chips)
Seat 2: Big Blind ($10.70 in chips)
Seat 3: UTG ($2.77 in chips)
Seat 4: UTGplus1 ($0.98 in chips)
Seat 5: UTGplus2 ($6.46 in chips)
Seat 6: Dealer ($15.47 in chips)
Hero: posts small blind $0.02
Big Blind: posts big blind $0.05
*** HOLE CARDS ***
Dealt to Hero [2s Ah]
UTG: folds
UTGplus1: folds
UTGplus2: folds
Dealer: raises $0.10 to $0.10
Hero: folds
Big Blind: calls $0.05 
*** FLOP *** [7c 8c 5s]
Big Blind: checks
Dealer: bets $0.10 
Big Blind: folds
Uncalled bet ($0.10) returned to Dealer
Dealer: doesn't show hand
Dealer collected $0.21 from pot
*** SUMMARY ***
Total pot $0.22 | Rake $0.01
Board [7c 8c 5s]
Seat 1: Hero (small blind) showed
Seat 2: Big Blind (big blind) showed
Seat 3: UTG showed
Seat 4: UTGplus1 showed
Seat 5: UTGplus2 showed
Seat 6: Dealer (button) won ($0.21)



PokerStars Zoom Hand #3434284732: Hold'em No Limit ($0.02/$0.05) - 2017/03/08 21:13:15
Table '#952' 6-max Seat #1 is the button
Seat 1: Dealer ($4.20 in chips)
Seat 2: Small Blind ($4.95 in chips)
Seat 3: Big Blind ($13.73 in chips)
Seat 4: UTG ($2.81 in chips)
Seat 5: Hero ($8.76 in chips)
Seat 6: UTGplus2 ($2.53 in chips)
Small Blind: posts small blind $0.02
Big Blind: posts big blind $0.05
*** HOLE CARDS ***
Dealt to Hero [2c 8c]
UTG: folds
Hero: folds
UTGplus2: folds
Dealer: folds
Small Blind: folds
Big Blind: doesn't show hand
Big Blind collected $0.07 from pot
*** SUMMARY ***
Total pot $0.07 | Rake $0.00
Seat 1: Dealer (button) showed
Seat 2: Small Blind (small blind) showed
Seat 3: Big Blind (big blind) won ($0.07)
Seat 4: UTG showed
Seat 5: Hero showed
Seat 6: UTGplus2 showed



PokerStars Zoom Hand #3434284786: Hold'em No Limit ($0.02/$0.05) - 2017/03/08 21:13:22
Table '#952' 6-max Seat #3 is the button
Seat 1: UTGplus1 ($4.94 in chips)
Seat 2: UTGplus2 ($9.29 in chips)
Seat 3: Dealer ($12.01 in chips)
Seat 4: Hero ($8.76 in chips)
Seat 5: Big Blind ($7.86 in chips)
Seat 6: UTG ($5.08 in chips)
Hero: posts small blind $0.02
Big Blind: posts big blind $0.05
*** HOLE CARDS ***
Dealt to Hero [Ks 8d]
UTG: folds
UTGplus1: raises $0.15 to $0.15
UTGplus2: calls $0.15 
Dealer: calls $0.15 
Hero: folds
Big Blind: folds
*** FLOP *** [Kh 9c 7c]
UTGplus1: bets $0.40 
UTGplus2: calls $0.40 
Dealer: calls $0.40 
*** TURN *** [Kh 9c 7c] [7d]
UTGplus1: bets $1.51 
UTGplus2: folds
Dealer: folds
Uncalled bet ($1.51) returned to UTGplus1
UTGplus1: doesn't show hand
UTGplus1 collected $1.64 from pot
*** SUMMARY ***
Total pot $1.72 | Rake $0.08
Board [Kh 9c 7c 7d]
Seat 1: UTGplus1 won ($1.64)
Seat 2: UTGplus2 showed
Seat 3: Dealer (button) showed
Seat 4: Hero (small blind) showed
Seat 5: Big Blind (big blind) showed
Seat 6: UTG showed



PokerStars Zoom Hand #3434284822: Hold'em No Limit ($0.02/$0.05) - 2017/03/08 21:13:27
Table '#952' 6-max Seat #1 is the button
Seat 1: Dealer ($2.10 in chips)
Seat 2: Small Blind ($4.93 in chips)
Seat 3: Hero ($8.74 in chips)
Seat 4: UTG ($5.26 in chips)
Seat 5: UTGplus1 ($5 in chips)
Seat 6: UTGplus2 ($4.20 in chips)
Small Blind: posts small blind $0.02
Hero: posts big blind $0.05
*** HOLE CARDS ***
Dealt to Hero [7c 4h]
UTG: folds
UTGplus1: folds
UTGplus2: folds
Dealer: calls $0.05 
Small Blind: folds
Hero: checks
*** FLOP *** [3c 8s 3h]
Hero: checks
Dealer: checks
*** TURN *** [3c 8s 3h] [Kd]
Hero: checks
Dealer: bets $0.20 
Hero: folds
Uncalled bet ($0.20) returned to Dealer
Dealer: doesn't show hand
Dealer collected $0.12 from pot
*** SUMMARY ***
Total pot $0.12 | Rake $0.00
Board [3c 8s 3h Kd]
Seat 1: Dealer (button) won ($0.12)
Seat 2: Small Blind (small blind) showed
Seat 3: Hero (big blind) showed
Seat 4: UTG showed
Seat 5: UTGplus1 showed
Seat 6: UTGplus2 showed



PokerStars Zoom Hand #3434284854: Hold'em No Limit ($0.02/$0.05) - 2017/03/08 21:13:31
Table '#952' 6-max Seat #1 is the button
Seat 1: Dealer ($8.80 in chips)
Seat 2: Small Blind ($4.91 in chips)
Seat 3: Big Blind ($4.20 in chips)
Seat 4: UTG ($6.28 in chips)
Seat 5: Hero ($8.69 in chips)
Seat 6: UTGplus2 ($5.26 in chips)
Small Blind: posts small blind $0.02
Big Blind: posts big blind $0.05
*** HOLE CARDS ***
Dealt to Hero [7h 2d]
UTG: folds
Hero: folds
UTGplus2: folds
Dealer: folds
Small Blind: folds
Big Blind: doesn't show hand
Big Blind collected $0.07 from pot
*** SUMMARY ***
Total pot $0.07 | Rake $0.00
Seat 1: Dealer (button) showed
Seat 2: Small Blind (small blind) showed
Seat 3: Big Blind (big blind) won ($0.07)
Seat 4: UTG showed
Seat 5: Hero showed
Seat 6: UTGplus2 showed



PokerStars Zoom Hand #3434284907: Hold'em No Limit ($0.02/$0.05) - 2017/03/08 21:13:37
Table '#952' 6-max Seat #4 is the button
Seat 1: UTG ($8.92 in chips)
Seat 2: UTGplus1 ($5.80 in chips)
Seat 3: UTGplus2 ($13.73 in chips)
Seat 4: Hero ($8.69 in chips)
Seat 5: Small Blind ($10.48 in chips)
Seat 6: Big Blind ($12.79 in chips)
Small Blind: posts small blind $0.02
Big Blind: posts big blind $0.05
*** HOLE CARDS ***
Dealt to Hero [2h 7h]
UTG: folds
UTGplus1: folds
UTGplus2: folds
Hero: folds
Small Blind: folds
Big Blind: doesn't show hand
Big Blind collected $0.07 from pot
*** SUMMARY ***
Total pot $0.07 | Rake $0.00
Seat 1: UTG showed
Seat 2: UTGplus1 showed
Seat 3: UTGplus2 showed
Seat 4: Hero (button) showed
Seat 5: Small Blind (small blind) showed
Seat 6: Big Blind (big blind) won ($0.07)



PokerStars Zoom Hand #3434284947: Hold'em No Limit ($0.02/$0.05) - 2017/03/08 21:13:42
Table '#952' 6-max Seat #1 is the button
Seat 1: Hero ($8.69 in chips)
Seat 2: Small Blind ($5.64 in chips)
Seat 3: Big Blind ($13.61 in chips)
Seat 4: UTG ($4.95 in chips)
Seat 5: UTGplus1 ($8.02 in chips)
Seat 6: UTGplus2 ($8.92 in chips)
Small Blind: posts small blind $0.02
Big Blind: posts big blind $0.05
*** HOLE CARDS ***
Dealt to Hero [Tc 5s]
UTG: folds
UTGplus1: raises $0.12 to $0.12
UTGplus2: folds
Hero: folds
Small Blind: folds
Big Blind: calls $0.07 
*** FLOP *** [Qh 9h Kc]
Big Blind: checks
UTGplus1: checks
*** TURN *** [Qh 9h Kc] [Td]
Big Blind: checks
UTGplus1: bets $0.21 
Big Blind: folds
Uncalled bet ($0.21) returned to UTGplus1
UTGplus1: doesn't show hand
UTGplus1 collected $0.25 from pot
*** SUMMARY ***
Total pot $0.26 | Rake $0.01
Board [Qh 9h Kc Td]
Seat 1: Hero (button) showed
Seat 2: Small Blind (small blind) showed
Seat 3: Big Blind (big blind) showed
Seat 4: UTG showed
Seat 5: UTGplus1 won ($0.25)
Seat 6: UTGplus2 showed



PokerStars Zoom Hand #3434284990: Hold'em No Limit ($0.02/$0.05) - 2017/03/08 21:13:47
Table '#952' 6-max Seat #5 is the button
Seat 1: Big Blind ($23.40 in chips)
Seat 2: Hero ($8.69 in chips)
Seat 3: UTGplus1 ($4.22 in chips)
Seat 4: UTGplus2 ($13.40 in chips)
Seat 5: Dealer ($1.90 in chips)
Seat 6: Small Blind ($13.73 in chips)
Small Blind: posts small blind $0.02
Big Blind: posts big blind $0.05
*** HOLE CARDS ***
Dealt to Hero [6s 8h]
Hero: folds
UTGplus1: folds
UTGplus2: folds
Dealer: folds
Small Blind: folds
Big Blind: doesn't show hand
Big Blind collected $0.07 from pot
*** SUMMARY ***
Total pot $0.07 | Rake $0.00
Seat 1: Big Blind (big blind) won ($0.07)
Seat 2: Hero showed
Seat 3: UTGplus1 showed
Seat 4: UTGplus2 showed
Seat 5: Dealer (button) showed
Seat 6: Small Blind (small blind) showed



PokerStars Zoom Hand #3434285032: Hold'em No Limit ($0.02/$0.05) - 2017/03/08 21:13:52
Table '#952' 6-max Seat #1 is the button
Seat 1: Dealer ($6.23 in chips)
Seat 2: Hero ($8.69 in chips)
Seat 3: Big Blind ($5 in chips)
Seat 4: UTG ($9.56 in chips)
Seat 5: UTGplus1 ($5.23 in chips)
Seat 6: UTGplus2 ($1.90 in chips)
Hero: posts small blind $0.02
Big Blind: posts big blind $0.05
*** HOLE CARDS ***
Dealt to Hero [9d 7c]
UTG: folds
UTGplus1: folds
UTGplus2: folds
Dealer: raises $0.10 to $0.10
Hero: folds
Big Blind: folds
Uncalled bet ($0.05) returned to Dealer
Dealer: doesn't show hand
Dealer collected $0.12 from pot
*** SUMMARY ***
Total pot $0.12 | Rake $0.00
Seat 1: Dealer (button) won ($0.12)
Seat 2: Hero (small blind) showed
Seat 3: Big Blind (big blind) showed
Seat 4: UTG showed
Seat 5: UTGplus1 showed
Seat 6: UTGplus2 showed



PokerStars Zoom Hand #3434285083: Hold'em No Limit ($0.02/$0.05) - 2017/03/08 21:13:58
Table '#952' 6-max Seat #2 is the button
Seat 1: UTGplus2 ($6.48 in chips)
Seat 2: Dealer ($7.66 in chips)
Seat 3: Small Blind ($3.94 in chips)
Seat 4: Big Blind ($13.71 in chips)
Seat 5: UTG ($3.65 in chips)
Seat 6: Hero ($8.67 in chips)
Small Blind: posts small blind $0.02
Big Blind: posts big blind $0.05
*** HOLE CARDS ***
Dealt to Hero [3s 6h]
UTG: folds
Hero: folds
UTGplus2: folds
Dealer: folds
Small Blind: folds
Big Blind: doesn't show hand
Big Blind collected $0.07 from pot
*** SUMMARY ***
Total pot $0.07 | Rake $0.00
Seat 1: UTGplus2 showed
Seat 2: Dealer (button) showed
Seat 3: Small Blind (small blind) showed
Seat 4: Big Blind (big blind) won ($0.07)
Seat 5: UTG showed
Seat 6: Hero showed



PokerStars Zoom Hand #3434285112: Hold'em No Limit ($0.02/$0.05) - 2017/03/08 21:14:02
Table '#952' 6-max Seat #4 is the button
Seat 1: UTG ($5.23 in chips)
Seat 2: UTGplus1 ($11.10 in chips)
Seat 3: UTGplus2 ($9.54 in chips)
Seat 4: Dealer ($10.46 in chips)
Seat 5: Small Blind ($6.31 in chips)
Seat 6: Hero ($8.67 in chips)
Small Blind: posts small blind $0.02
Hero: posts big blind $0.05
*** HOLE CARDS ***
Dealt to Hero [As 9d]
UTG: raises $0.17 to $0.17
UTGplus1: folds
UTGplus2: folds
Dealer: folds
Small Blind: folds
Hero: calls $0.12 
*** FLOP *** [Kd 6c 5h]
Hero: checks
UTG: bets $0.36 
Hero: folds
Uncalled bet ($0.36) returned to UTG
UTG: doesn't show hand
UTG collected $0.35 from pot
*** SUMMARY ***
Total pot $0.36 | Rake $0.01
Board [Kd 6c 5h]
Seat 1: UTG won ($0.35)
Seat 2: UTGplus1 showed
Seat 3: UTGplus2 showed
Seat 4: Dealer (button) showed
Seat 5: Small Blind (small blind) showed
Seat 6: Hero (big blind) showed



PokerStars Zoom Hand #3434285306: Hold'em No Limit ($0.02/$0.05) - 2017/03/08 21:14:26
Table '#952' 6-max Seat #5 is the button
Seat 1: Big Blind ($4.27 in chips)
Seat 2: UTG ($1.81 in chips)
Seat 3: UTGplus1 ($4.07 in chips)
Seat 4: UTGplus2 ($5.74 in chips)
Seat 5: Dealer ($5.05 in chips)
Seat 6: Hero ($8.50 in chips)
Hero: posts small blind $0.02
Big Blind: posts big blind $0.05
*** HOLE CARDS ***
Dealt to Hero [Js 8c]
UTG: calls $0.05 
UTGplus1: folds
UTGplus2: raises $0.15 to $0.15
Dealer: calls $0.15 
Hero: folds
Big Blind: folds
UTG: calls $0.10 
*** FLOP *** [6d As 5d]
UTG: checks
UTGplus2: checks
Dealer: checks
*** TURN *** [6d As 5d] [3d]
UTG: checks
UTGplus2: checks
Dealer: checks
*** RIVER *** [6d As 5d 3d] [Ac]
UTG: bets $0.52 
UTGplus2: folds
Dealer: folds
Uncalled bet ($0.52) returned to UTG
UTG: doesn't show hand
UTG collected $0.5 from pot
*** SUMMARY ***
Total pot $0.52 | Rake $0.02
Board [6d As 5d 3d Ac]
Seat 1: Big Blind (big blind) showed
Seat 2: UTG won ($0.5)
Seat 3: UTGplus1 showed
Seat 4: UTGplus2 showed
Seat 5: Dealer (button) showed
Seat 6: Hero (small blind) showed



PokerStars Zoom Hand #3434285364: Hold'em No Limit ($0.02/$0.05) - 2017/03/08 21:14:33
Table '#952' 6-max Seat #6 is the button
Seat 1: Hero ($8.48 in chips)
Seat 2: Big Blind ($2.50 in chips)
Seat 3: UTG ($4.63 in chips)
Seat 4: UTGplus1 ($6.77 in chips)
Seat 5: UTGplus2 ($4.68 in chips)
Seat 6: Dealer ($2.62 in chips)
Hero: posts small blind $0.02
Big Blind: posts big blind $0.05
*** HOLE CARDS ***
Dealt to Hero [7d 3d]
UTG: calls $0.05 
UTGplus1: folds
UTGplus2: calls $0.05 
Dealer: folds
Hero: folds
Big Blind: raises $0.05 to $0.10
UTG: raises $4.53 to $4.63 and is all-in
UTGplus2: folds
Big Blind: calls $2.40 and is all-in
*** FLOP *** [Jh 7s 7c]
*** TURN *** [Jh 7s 7c] [8s]
*** RIVER *** [Jh 7s 7c 8s] [4h]
*** SHOW DOWN ***
Big Blind: shows [6s Jd] (two pair, Jacks and Eights)
UTG: shows [2h 2s] (two pair, Sevens and Jacks)
Uncalled bet ($2.13) returned to UTG
Big Blind collected $4.82 from pot
*** SUMMARY ***
Total pot $5.07 | Rake $0.25
Board [Jh 7s 7c 8s 4h]
Seat 1: Hero (small blind) showed
Seat 2: Big Blind (big blind) showed [6s Jd] and won ($4.82) with two pair, Sevens and Jacks
Seat 3: UTG showed [2h 2s] and lost with two pair, Sevens and Jacks
Seat 4: UTGplus1 showed
Seat 5: UTGplus2 showed
Seat 6: Dealer (button) showed



PokerStars Zoom Hand #3434285397: Hold'em No Limit ($0.02/$0.05) - 2017/03/08 21:14:37
Table '#952' 6-max Seat #5 is the button
Seat 1: Big Blind ($2.50 in chips)
Seat 2: UTG ($3.56 in chips)
Seat 3: UTGplus1 ($2.62 in chips)
Seat 4: UTGplus2 ($2.55 in chips)
Seat 5: Dealer ($4.05 in chips)
Seat 6: Hero ($8.46 in chips)
Hero: posts small blind $0.02
Big Blind: posts big blind $0.05
*** HOLE CARDS ***
Dealt to Hero [Qh 4s]
UTG: folds
UTGplus1: folds
UTGplus2: folds
Dealer: folds
Hero: folds
Big Blind: doesn't show hand
Big Blind collected $0.07 from pot
*** SUMMARY ***
Total pot $0.07 | Rake $0.00
Seat 1: Big Blind (big blind) won ($0.07)
Seat 2: UTG showed
Seat 3: UTGplus1 showed
Seat 4: UTGplus2 showed
Seat 5: Dealer (button) showed
Seat 6: Hero (small blind) showed



PokerStars Zoom Hand #3434285441: Hold'em No Limit ($0.02/$0.05) - 2017/03/08 21:14:42
Table '#952' 6-max Seat #2 is the button
Seat 1: Hero ($8.44 in chips)
Seat 2: Dealer ($2.55 in chips)
Seat 3: Small Blind ($9.02 in chips)
Seat 4: Big Blind ($9.15 in chips)
Seat 5: UTG ($11.53 in chips)
Seat 6: UTGplus1 ($13.65 in chips)
Small Blind: posts small blind $0.02
Big Blind: posts big blind $0.05
*** HOLE CARDS ***
Dealt to Hero [6d 9s]
UTG: calls $0.05 
UTGplus1: raises $0.20 to $0.20
Hero: folds
Dealer: folds
Small Blind: folds
Big Blind: raises $0.36 to $0.41
UTG: folds
UTGplus1: raises $1.10 to $1.30
Big Blind: folds 
Uncalled bet ($0.89) returned to UTGplus1
UTGplus1: doesn't show hand
UTGplus1 collected $0.89 from pot
*** SUMMARY ***
Total pot $0.89 | Rake $0.00
Seat 1: Hero showed
Seat 2: Dealer (button) showed
Seat 3: Small Blind (small blind) showed
Seat 4: Big Blind (big blind) showed
Seat 5: UTG showed
Seat 6: UTGplus1 won ($0.89)



PokerStars Zoom Hand #3434285485: Hold'em No Limit ($0.02/$0.05) - 2017/03/08 21:14:47
Table '#952' 6-max Seat #6 is the button
Seat 1: Small Blind ($10.53 in chips)
Seat 2: Hero ($8.44 in chips)
Seat 3: UTG ($4.12 in chips)
Seat 4: UTGplus1 ($6.18 in chips)
Seat 5: UTGplus2 ($2.90 in chips)
Seat 6: Dealer ($5.85 in chips)
Small Blind: posts small blind $0.02
Hero: posts big blind $0.05
*** HOLE CARDS ***
Dealt to Hero [3d Qh]
UTG: folds
UTGplus1: raises $0.17 to $0.17
UTGplus2: folds
Dealer: calls $0.17 
Small Blind: folds
Hero: folds
*** FLOP *** [6h 4h 3c]
UTGplus1: bets $0.41 
Dealer: calls $0.41 
*** TURN *** [6h 4h 3c] [Qd]
UTGplus1: checks
Dealer: bets $0.25 
UTGplus1: calls $0.25 
*** RIVER *** [6h 4h 3c Qd] [Jc]
UTGplus1: bets $1.73 
Dealer: calls $1.73 
*** SHOW DOWN ***
UTGplus1: shows [4d Js] (two pair, Jacks and Queens)
Dealer: shows [Kc Qc] (a pair of Queens)
UTGplus1 collected $4.94 from pot
*** SUMMARY ***
Total pot $5.19 | Rake $0.25
Board [6h 4h 3c Qd Jc]
Seat 1: Small Blind (small blind) showed
Seat 2: Hero (big blind) showed
Seat 3: UTG showed
Seat 4: UTGplus1 showed [4d Js] and won ($4.94) with two pair, Queens and Sixes
Seat 5: UTGplus2 showed
Seat 6: Dealer (button) showed [Kc Qc] and lost with a pair of Queens



PokerStars Zoom Hand #3434285525: Hold'em No Limit ($0.02/$0.05) - 2017/03/08 21:14:52
Table '#952' 6-max Seat #6 is the button
Seat 1: Small Blind ($3.77 in chips)
Seat 2: Big Blind ($4.67 in chips)
Seat 3: Hero ($8.39 in chips)
Seat 4: UTGplus1 ($13.41 in chips)
Seat 5: UTGplus2 ($5 in chips)
Seat 6: Dealer ($4.12 in chips)
Small Blind: posts small blind $0.02
Big Blind: posts big blind $0.05
*** HOLE CARDS ***
Dealt to Hero [6h 7h]
Hero: raises $0.17 to $0.17
UTGplus1: folds
UTGplus2: folds
Dealer: folds
Small Blind: folds
Big Blind: folds
Uncalled bet ($0.12) returned to Hero
Hero: doesn't show hand
Hero collected $0.12 from pot
*** SUMMARY ***
Total pot $0.12 | Rake $0.00
Seat 1: Small Blind (small blind) showed
Seat 2: Big Blind (big blind) showed
Seat 3: Hero won ($0.12)
Seat 4: UTGplus1 showed
Seat 5: UTGplus2 showed
Seat 6: Dealer (button) showed



PokerStars Zoom Hand #3434285716: Hold'em No Limit ($0.02/$0.05) - 2017/03/08 21:15:19
Table '#952' 6-max Seat #5 is the button
Seat 1: Big Blind ($5 in chips)
Seat 2: UTG ($12.81 in chips)
Seat 3: UTGplus1 ($9.49 in chips)
Seat 4: Hero ($8.46 in chips)
Seat 5: Dealer ($8.15 in chips)
Seat 6: Small Blind ($5.33 in chips)
Small Blind: posts small blind $0.02
Big Blind: posts big blind $0.05
*** HOLE CARDS ***
Dealt to Hero [Qs 4s]
UTG: folds
UTGplus1: folds
Hero: folds
Dealer: folds
Small Blind: folds
Big Blind: doesn't show hand
Big Blind collected $0.07 from pot
*** SUMMARY ***
Total pot $0.07 | Rake $0.00
Seat 1: Big Blind (big blind) won ($0.07)
Seat 2: UTG showed
Seat 3: UTGplus1 showed
Seat 4: Hero showed
Seat 5: Dealer (button) showed
Seat 6: Small Blind (small blind) showed



PokerStars Zoom Hand #3434285790: Hold'em No Limit ($0.02/$0.05) - 2017/03/08 21:15:29
Table '#952' 6-max Seat #4 is the button
Seat 1: UTG ($2.90 in chips)
Seat 2: UTGplus1 ($4.85 in chips)
Seat 3: UTGplus2 ($3.95 in chips)
Seat 4: Hero ($8.46 in chips)
Seat 5: Small Blind ($3.16 in chips)
Seat 6: Big Blind ($4.10 in chips)
Small Blind: posts small blind $0.02
Big Blind: posts big blind $0.05
*** HOLE CARDS ***
Dealt to Hero [5c 2h]
UTG: folds
UTGplus1: folds
UTGplus2: folds
Hero: folds
Small Blind: folds
Big Blind: doesn't show hand
Big Blind collected $0.07 from pot
Table deposit $5 
*** SUMMARY ***
Total pot $0.07 | Rake $0.00
Seat 1: UTG showed
Seat 2: UTGplus1 showed
Seat 3: UTGplus2 showed
Seat 4: Hero (button) showed
Seat 5: Small Blind (small blind) showed
Seat 6: Big Blind (big blind) won ($0.07)



PokerStars Zoom Hand #3434285839: Hold'em No Limit ($0.02/$0.05) - 2017/03/08 21:15:35
Table '#952' 6-max Seat #5 is the button
Seat 1: Big Blind ($14.13 in chips)
Seat 2: UTG ($6.13 in chips)
Seat 3: Hero ($8.46 in chips)
Seat 4: UTGplus2 ($3.67 in chips)
Seat 5: Dealer ($4.90 in chips)
Seat 6: Small Blind ($2.04 in chips)
Small Blind: posts small blind $0.02
Big Blind: posts big blind $0.05
*** HOLE CARDS ***
Dealt to Hero [9d Td]
UTG: folds
Hero: raises $0.17 to $0.17
UTGplus2: folds
Dealer: folds
Small Blind: folds
Big Blind: calls $0.12 
*** FLOP *** [2s 7h 9s]
Big Blind: checks
Hero: bets $0.18 
Big Blind: calls $0.18 
*** TURN *** [2s 7h 9s] [8s]
Big Blind: checks
Hero: bets $0.41 
Big Blind: folds
Uncalled bet ($0.41) returned to Hero
Hero: doesn't show hand
Hero collected $0.69 from pot
*** SUMMARY ***
Total pot $0.72 | Rake $0.03
Board [2s 7h 9s 8s]
Seat 1: Big Blind (big blind) showed
Seat 2: UTG showed
Seat 3: Hero won ($0.69)
Seat 4: UTGplus2 showed
Seat 5: Dealer (button) showed
Seat 6: Small Blind (small blind) showed



PokerStars Zoom Hand #3434286185: Hold'em No Limit ($0.02/$0.05) - 2017/03/08 21:16:16
Table '#952' 6-max Seat #6 is the button
Seat 1: Small Blind ($4.53 in chips)
Seat 2: Big Blind ($5.52 in chips)
Seat 3: UTG ($2.77 in chips)
Seat 4: Hero ($8.80 in chips)
Seat 5: UTGplus2 ($11.55 in chips)
Seat 6: Dealer ($5.59 in chips)
Small Blind: posts small blind $0.02
Big Blind: posts big blind $0.05
*** HOLE CARDS ***
Dealt to Hero [Ts 9d]
UTG: folds
Hero: folds
UTGplus2: folds
Dealer: raises $0.14 to $0.14
Small Blind: calls $0.12 
Big Blind: folds
*** FLOP *** [Kh Jc As]
Small Blind: checks
Dealer: bets $0.17 
Small Blind: calls $0.17 
*** TURN *** [Kh Jc As] [5c]
Small Blind: checks
Dealer: checks
*** RIVER *** [Kh Jc As 5c] [2s]
Small Blind: checks
Dealer: bets $0.67 
Small Blind: folds
Uncalled bet ($0.67) returned to Dealer
Dealer: doesn't show hand
Dealer collected $0.64 from pot
*** SUMMARY ***
Total pot $0.67 | Rake $0.03
Board [Kh Jc As 5c 2s]
Seat 1: Small Blind (small blind) showed
Seat 2: Big Blind (big blind) showed
Seat 3: UTG showed
Seat 4: Hero showed
Seat 5: UTGplus2 showed
Seat 6: Dealer (button) won ($0.64)



PokerStars Zoom Hand #3434286240: Hold'em No Limit ($0.02/$0.05) - 2017/03/08 21:16:23
Table '#952' 6-max Seat #6 is the button
Seat 1: Small Blind ($2.35 in chips)
Seat 2: Hero ($8.80 in chips)
Seat 3: UTG ($4.95 in chips)
Seat 4: UTGplus1 ($9.24 in chips)
Seat 5: UTGplus2 ($3.29 in chips)
Seat 6: Dealer ($5.83 in chips)
Small Blind: posts small blind $0.02
Hero: posts big blind $0.05
*** HOLE CARDS ***
Dealt to Hero [8d 6s]
UTG: folds
UTGplus1: folds
UTGplus2: folds
Dealer: folds
Small Blind: raises $0.08 to $0.10
Hero: folds
Uncalled bet ($0.05) returned to Small Blind
Small Blind: doesn't show hand
Small Blind collected $0.1 from pot
*** SUMMARY ***
Total pot $0.1 | Rake $0.00
Seat 1: Small Blind (small blind) won ($0.1)
Seat 2: Hero (big blind) showed
Seat 3: UTG showed
Seat 4: UTGplus1 showed
Seat 5: UTGplus2 showed
Seat 6: Dealer (button) showed



PokerStars Zoom Hand #3434286286: Hold'em No Limit ($0.02/$0.05) - 2017/03/08 21:16:28
Table '#952' 6-max Seat #6 is the button
Seat 1: Small Blind ($2.95 in chips)
Seat 2: Big Blind ($3.29 in chips)
Seat 3: UTG ($24.18 in chips)
Seat 4: UTGplus1 ($7.63 in chips)
Seat 5: Hero ($8.75 in chips)
Seat 6: Dealer ($2.90 in chips)
Small Blind: posts small blind $0.02
Big Blind: posts big blind $0.05
*** HOLE CARDS ***
Dealt to Hero [Ad 3d]
UTG: folds
UTGplus1: folds
Hero: raises $0.17 to $0.17
Dealer: calls $0.17 
Small Blind: folds
Big Blind: folds
*** FLOP *** [4d 2s Ts]
Hero: bets $0.25 
Dealer: folds
Uncalled bet ($0.25) returned to Hero
Hero: doesn't show hand
Hero collected $0.39 from pot
*** SUMMARY ***
Total pot $0.41 | Rake $0.02
Board [4d 2s Ts]
Seat 1: Small Blind (small blind) showed
Seat 2: Big Blind (big blind) showed
Seat 3: UTG showed
Seat 4: UTGplus1 showed
Seat 5: Hero won ($0.39)
Seat 6: Dealer (button) showed



PokerStars Zoom Hand #3434286511: Hold'em No Limit ($0.02/$0.05) - 2017/03/08 21:16:55
Table '#952' 6-max Seat #2 is the button
Seat 1: UTGplus2 ($6.65 in chips)
Seat 2: Dealer ($8.57 in chips)
Seat 3: Small Blind ($24.07 in chips)
Seat 4: Big Blind ($11.11 in chips)
Seat 5: Hero ($8.97 in chips)
Seat 6: UTGplus1 ($6.20 in chips)
Small Blind: posts small blind $0.02
Big Blind: posts big blind $0.05
*** HOLE CARDS ***
Dealt to Hero [Ks Tc]
Hero: folds
UTGplus1: folds
UTGplus2: folds
Dealer: folds
Small Blind: raises $0.13 to $0.15
Big Blind: calls $0.10 
*** FLOP *** [Qh 7d 5s]
Small Blind: checks
Big Blind: checks
*** TURN *** [Qh 7d 5s] [8d]
Small Blind: checks
Big Blind: checks
*** RIVER *** [Qh 7d 5s 8d] [4h]
Small Blind: bets $0.09 
Big Blind: folds
Uncalled bet ($0.09) returned to Small Blind
Small Blind: doesn't show hand
Small Blind collected $0.29 from pot
*** SUMMARY ***
Total pot $0.3 | Rake $0.01
Board [Qh 7d 5s 8d 4h]
Seat 1: UTGplus2 showed
Seat 2: Dealer (button) showed
Seat 3: Small Blind (small blind) won ($0.29)
Seat 4: Big Blind (big blind) showed
Seat 5: Hero showed
Seat 6: UTGplus1 showed



PokerStars Zoom Hand #3434286604: Hold'em No Limit ($0.02/$0.05) - 2017/03/08 21:17:07
Table '#952' 6-max Seat #6 is the button
Seat 1: Small Blind ($4.66 in chips)
Seat 2: Big Blind ($1.72 in chips)
Seat 3: Hero ($8.97 in chips)
Seat 4: UTGplus1 ($8.14 in chips)
Seat 5: UTGplus2 ($2.38 in chips)
Seat 6: Dealer ($7.78 in chips)
Small Blind: posts small blind $0.02
Big Blind: posts big blind $0.05
*** HOLE CARDS ***
Dealt to Hero [4h 6s]
Hero: folds
UTGplus1: folds
UTGplus2: raises $0.10 to $0.10
Dealer: folds
Small Blind: folds
Big Blind: folds
Uncalled bet ($0.05) returned to UTGplus2
UTGplus2: doesn't show hand
UTGplus2 collected $0.12 from pot
*** SUMMARY ***
Total pot $0.12 | Rake $0.00
Seat 1: Small Blind (small blind) showed
Seat 2: Big Blind (big blind) showed
Seat 3: Hero showed
Seat 4: UTGplus1 showed
Seat 5: UTGplus2 won ($0.12)
Seat 6: Dealer (button) showed



PokerStars Zoom Hand #3434286640: Hold'em No Limit ($0.02/$0.05) - 2017/03/08 21:17:12
Table '#952' 6-max Seat #6 is the button
Seat 1: Small Blind ($11.02 in chips)
Seat 2: Big Blind ($4.98 in chips)
Seat 3: Hero ($8.97 in chips)
Seat 4: UTGplus1 ($4.61 in chips)
Seat 5: UTGplus2 ($6.18 in chips)
Seat 6: Dealer ($23.92 in chips)
Small Blind: posts small blind $0.02
Big Blind: posts big blind $0.05
*** HOLE CARDS ***
Dealt to Hero [Ks Qd]
Hero: raises $0.17 to $0.17
UTGplus1: calls $0.17 
UTGplus2: folds
Dealer: folds
Small Blind: folds
Big Blind: folds
*** FLOP *** [3h 7s Ah]
Hero: bets $0.25 
UTGplus1: calls $0.25 
*** TURN *** [3h 7s Ah] [4h]
Hero: checks
UTGplus1: checks
*** RIVER *** [3h 7s Ah 4h] [7h]
Hero: checks
UTGplus1: bets $0.91 
Hero: folds
Uncalled bet ($0.91) returned to UTGplus1
UTGplus1: doesn't show hand
UTGplus1 collected $0.87 from pot
*** SUMMARY ***
Total pot $0.91 | Rake $0.04
Board [3h 7s Ah 4h 7h]
Seat 1: Small Blind (small blind) showed
Seat 2: Big Blind (big blind) showed
Seat 3: Hero showed
Seat 4: UTGplus1 won ($0.87)
Seat 5: UTGplus2 showed
Seat 6: Dealer (button) showed



PokerStars Zoom Hand #3434286993: Hold'em No Limit ($0.02/$0.05) - 2017/03/08 21:17:57
Table '#952' 6-max Seat #3 is the button
Seat 1: UTGplus1 ($6.20 in chips)
Seat 2: UTGplus2 ($4.48 in chips)
Seat 3: Dealer ($2.41 in chips)
Seat 4: Small Blind ($2.61 in chips)
Seat 5: Big Blind ($23.56 in chips)
Seat 6: Hero ($8.55 in chips)
Small Blind: posts small blind $0.02
Big Blind: posts big blind $0.05
*** HOLE CARDS ***
Dealt to Hero [7c Jc]
Hero: folds
UTGplus1: folds
UTGplus2: folds
Dealer: raises $0.15 to $0.15
Small Blind: folds
Big Blind: calls $0.10 
*** FLOP *** [5d Kh 7h]
Big Blind: bets $0.16 
Dealer: calls $0.16 
*** TURN *** [5d Kh 7h] [Qd]
Big Blind: checks
Dealer: checks
*** RIVER *** [5d Kh 7h Qd] [Jh]
Big Blind: bets $0.64 
Dealer: calls $0.64 
*** SHOW DOWN ***
Big Blind: shows [Jd 7d] (two pair, Jacks and Kings)
Dealer: shows [9h 8h] (a flush, King high)
Dealer collected $1.83 from pot
Table deposit $2.50 
Seat re-join
*** SUMMARY ***
Total pot $1.92 | Rake $0.09
Board [5d Kh 7h Qd Jh]
Seat 1: UTGplus1 showed
Seat 2: UTGplus2 showed
Seat 3: Dealer (button) showed [9h 8h] and won ($1.83) with a flush, King high
Seat 4: Small Blind (small blind) showed
Seat 5: Big Blind (big blind) showed [Jd 7d] and lost with two pair, Jacks and Kings
Seat 6: Hero showed



PokerStars Zoom Hand #3434287041: Hold'em No Limit ($0.02/$0.05) - 2017/03/08 21:18:04
Table '#952' 6-max Seat #3 is the button
Seat 1: UTGplus1 ($1.85 in chips)
Seat 2: UTGplus2 ($11.50 in chips)
Seat 3: Dealer ($5.63 in chips)
Seat 4: Small Blind ($4.65 in chips)
Seat 5: Big Blind ($5.27 in chips)
Seat 6: Hero ($8.55 in chips)
Small Blind: posts small blind $0.02
Big Blind: posts big blind $0.05
*** HOLE CARDS ***
Dealt to Hero [Js As]
Hero: raises $0.17 to $0.17
UTGplus1: folds
UTGplus2: folds
Dealer: folds
Small Blind: folds
Big Blind: calls $0.12 
*** FLOP *** [Jc Qs 4d]
Big Blind: checks
Hero: bets $0.23 
Big Blind: calls $0.23 
*** TURN *** [Jc Qs 4d] [Ac]
Big Blind: checks
Hero: bets $0.51 
Big Blind: calls $0.51 
*** RIVER *** [Jc Qs 4d Ac] [Kd]
Big Blind: bets $1.12 
Hero: calls $1.12 
*** SHOW DOWN ***
Big Blind: shows [Ts Ad] (a straight, Ten to Ace)
Hero: shows [Js As] (Two pair)
Big Blind collected $3.88 from pot
*** SUMMARY ***
Total pot $4.08 | Rake $0.20
Board [Jc Qs 4d Ac Kd]
Seat 1: UTGplus1 showed
Seat 2: UTGplus2 showed
Seat 3: Dealer (button) showed
Seat 4: Small Blind (small blind) showed
Seat 5: Big Blind (big blind) showed [Ts Ad] and won ($3.88) with a straight, Ten to Ace
Seat 6: Hero showed [Js As]



PokerStars Zoom Hand #3434287739: Hold'em No Limit ($0.02/$0.05) - 2017/03/08 21:19:30
Table '#952' 6-max Seat #4 is the button
Seat 1: UTG ($2.50 in chips)
Seat 2: UTGplus1 ($6.26 in chips)
Seat 3: UTGplus2 ($5.27 in chips)
Seat 4: Dealer ($8.63 in chips)
Seat 5: Small Blind ($7.12 in chips)
Seat 6: Hero ($6.52 in chips)
Small Blind: posts small blind $0.02
Hero: posts big blind $0.05
*** HOLE CARDS ***
Dealt to Hero [Ah 6s]
UTG: folds
UTGplus1: folds
UTGplus2: folds
Dealer: raises $0.12 to $0.12
Small Blind: calls $0.10 
Hero: folds
*** FLOP *** [4d Qc Jh]
Small Blind: checks
Dealer: bets $0.15 
Small Blind: folds
Uncalled bet ($0.15) returned to Dealer
Dealer: doesn't show hand
Dealer collected $0.28 from pot
*** SUMMARY ***
Total pot $0.29 | Rake $0.01
Board [4d Qc Jh]
Seat 1: UTG showed
Seat 2: UTGplus1 showed
Seat 3: UTGplus2 showed
Seat 4: Dealer (button) won ($0.28)
Seat 5: Small Blind (small blind) showed
Seat 6: Hero (big blind) showed



PokerStars Zoom Hand #3434287782: Hold'em No Limit ($0.02/$0.05) - 2017/03/08 21:19:36
Table '#952' 6-max Seat #6 is the button
Seat 1: Hero ($6.47 in chips)
Seat 2: Big Blind ($1.39 in chips)
Seat 3: UTG ($3.09 in chips)
Seat 4: UTGplus1 ($9.95 in chips)
Seat 5: UTGplus2 ($4.95 in chips)
Seat 6: Dealer ($13.06 in chips)
Hero: posts small blind $0.02
Big Blind: posts big blind $0.05
*** HOLE CARDS ***
Dealt to Hero [Js 3s]
UTG: folds 
UTGplus1: folds
UTGplus2: folds
Dealer: folds
Hero: folds
Big Blind: doesn't show hand
Big Blind collected $0.07 from pot
*** SUMMARY ***
Total pot $0.07 | Rake $0.00
Seat 1: Hero (small blind) showed
Seat 2: Big Blind (big blind) won ($0.07)
Seat 3: UTG showed
Seat 4: UTGplus1 showed
Seat 5: UTGplus2 showed
Seat 6: Dealer (button) showed



PokerStars Zoom Hand #3434287822: Hold'em No Limit ($0.02/$0.05) - 2017/03/08 21:19:40
Table '#952' 6-max Seat #5 is the button
Seat 1: Big Blind ($2.50 in chips)
Seat 2: UTG ($5.31 in chips)
Seat 3: UTGplus1 ($2.57 in chips)
Seat 4: UTGplus2 ($3.75 in chips)
Seat 5: Dealer ($13.06 in chips)
Seat 6: Hero ($6.45 in chips)
Hero: posts small blind $0.02
Big Blind: posts big blind $0.05
*** HOLE CARDS ***
Dealt to Hero [7c Ac]
UTG: folds
UTGplus1: folds
UTGplus2: folds
Dealer: folds
Hero: raises $0.13 to $0.15
Big Blind: folds
Uncalled bet ($0.10) returned to Hero
Hero: doesn't show hand
Hero collected $0.1 from pot
*** SUMMARY ***
Total pot $0.1 | Rake $0.00
Seat 1: Big Blind (big blind) showed
Seat 2: UTG showed
Seat 3: UTGplus1 showed
Seat 4: UTGplus2 showed
Seat 5: Dealer (button) showed
Seat 6: Hero (small blind) won ($0.1)



PokerStars Zoom Hand #3434288020: Hold'em No Limit ($0.02/$0.05) - 2017/03/08 21:20:02
Table '#952' 6-max Seat #4 is the button
Seat 1: Hero ($6.50 in chips)
Seat 2: UTGplus1 ($2.61 in chips)
Seat 3: UTGplus2 ($6.98 in chips)
Seat 4: Dealer ($22.40 in chips)
Seat 5: Small Blind ($4.45 in chips)
Seat 6: Big Blind ($13.06 in chips)
Small Blind: posts small blind $0.02
Big Blind: posts big blind $0.05
*** HOLE CARDS ***
Dealt to Hero [9c 6h]
Hero: folds
UTGplus1: folds
UTGplus2: raises $0.15 to $0.15
Dealer: folds
Small Blind: folds
Big Blind: calls $0.10 
*** FLOP *** [Ks 8c 7d]
Big Blind: checks
UTGplus2: checks
*** TURN *** [Ks 8c 7d] [Kh]
Big Blind: checks
UTGplus2: checks
*** RIVER *** [Ks 8c 7d Kh] [3s]
Big Blind: checks
UTGplus2: checks
*** SHOW DOWN ***
Big Blind: shows [Ah 5s] (a pair of Kings)
UTGplus2: shows [4c 7c] (two pair, Kings and Eights)
UTGplus2 collected $0.31 from pot
*** SUMMARY ***
Total pot $0.32 | Rake $0.01
Board [Ks 8c 7d Kh 3s]
Seat 1: Hero showed
Seat 2: UTGplus1 showed
Seat 3: UTGplus2 showed [4c 7c] and won ($0.31) with two pair, Kings and Eights
Seat 4: Dealer (button) showed
Seat 5: Small Blind (small blind) showed
Seat 6: Big Blind (big blind) showed [Ah 5s] and lost with a pair of Kings



PokerStars Zoom Hand #3434288057: Hold'em No Limit ($0.02/$0.05) - 2017/03/08 21:20:07
Table '#952' 6-max Seat #5 is the button
Seat 1: Big Blind ($12.44 in chips)
Seat 2: UTG ($2.45 in chips)
Seat 3: UTGplus1 ($4.95 in chips)
Seat 4: UTGplus2 ($10.89 in chips)
Seat 5: Dealer ($7.06 in chips)
Seat 6: Hero ($6.50 in chips)
Hero: posts small blind $0.02
Big Blind: posts big blind $0.05
*** HOLE CARDS ***
Dealt to Hero [Kd 2s]
UTG: folds
UTGplus1: folds
UTGplus2: folds
Dealer: raises $0.14 to $0.14
Hero: folds
Big Blind: calls $0.09 
*** FLOP *** [3c 7c 7s]
Big Blind: checks
Dealer: bets $0.18 
Big Blind: calls $0.18 
*** TURN *** [3c 7c 7s] [Qc]
Big Blind: checks
Dealer: checks
*** RIVER *** [3c 7c 7s Qc] [9d]
Big Blind: checks
Dealer: bets $0.35 
Big Blind: calls $0.35 
*** SHOW DOWN ***
Dealer: shows [8c 9c] (a flush, Queen high)
Big Blind: shows [Tc As] (One pair)
Dealer collected $1.3 from pot
*** SUMMARY ***
Total pot $1.36 | Rake $0.06
Board [3c 7c 7s Qc 9d]
Seat 1: Big Blind (big blind) showed [Tc As]
Seat 2: UTG showed
Seat 3: UTGplus1 showed
Seat 4: UTGplus2 showed
Seat 5: Dealer (button) showed [8c 9c] and won ($1.3) with a flush, Queen high
Seat 6: Hero (small blind) showed



PokerStars Zoom Hand #3434288095: Hold'em No Limit ($0.02/$0.05) - 2017/03/08 21:20:12
Table '#952' 6-max Seat #4 is the button
Seat 1: UTG ($2.45 in chips)
Seat 2: UTGplus1 ($7.59 in chips)
Seat 3: UTGplus2 ($10.89 in chips)
Seat 4: Dealer ($2.54 in chips)
Seat 5: Hero ($6.48 in chips)
Seat 6: Big Blind ($6.47 in chips)
Hero: posts small blind $0.02
Big Blind: posts big blind $0.05
*** HOLE CARDS ***
Dealt to Hero [6d 3d]
UTG: folds
UTGplus1: raises $0.15 to $0.15
UTGplus2: folds
Dealer: folds
Hero: folds
Big Blind: calls $0.10 
*** FLOP *** [6s As 8s]
Big Blind: bets $0.32 
UTGplus1: calls $0.32 
*** TURN *** [6s As 8s] [Tc]
Big Blind: bets $0.25 
UTGplus1: raises $0.85 to $0.85
Big Blind: calls $0.60 
*** RIVER *** [6s As 8s Tc] [8d]
Big Blind: checks
UTGplus1: bets $1.33 
Big Blind: calls $1.33 
*** SHOW DOWN ***
UTGplus1: shows [Ks Qc] (a pair of Eights)
Big Blind: shows [Ad Td] (two pair, Aces and Eights)
Big Blind collected $5.06 from pot
*** SUMMARY ***
Total pot $5.32 | Rake $0.26
Board [6s As 8s Tc 8d]
Seat 1: UTG showed
Seat 2: UTGplus1 showed [Ks Qc] and lost with a pair of Eights
Seat 3: UTGplus2 showed
Seat 4: Dealer (button) showed
Seat 5: Hero (small blind) showed
Seat 6: Big Blind (big blind) showed [Ad Td] and won ($5.06) with two pair, Aces and Eights



PokerStars Zoom Hand #3434288217: Hold'em No Limit ($0.02/$0.05) - 2017/03/08 21:20:27
Table '#952' 6-max Seat #5 is the button
Seat 1: Big Blind ($2.40 in chips)
Seat 2: UTG ($2.23 in chips)
Seat 3: Hero ($6.46 in chips)
Seat 4: UTGplus2 ($5.43 in chips)
Seat 5: Dealer ($4.50 in chips)
Seat 6: Small Blind ($4.95 in chips)
Small Blind: posts small blind $0.02
Big Blind: posts big blind $0.05
*** HOLE CARDS ***
Dealt to Hero [Ac 8h]
UTG: raises $0.10 to $0.10
Hero: folds
UTGplus2: folds
Dealer: folds
Small Blind: folds
Big Blind: calls $0.05 
*** FLOP *** [Js 3h 2h]
Big Blind: checks
UTG: bets $0.11 
Big Blind: raises $0.32 to $0.32
UTG: raises $0.42 to $0.53
Big Blind: calls $0.21 
*** TURN *** [Js 3h 2h] [Jc]
Big Blind: checks
UTG: bets $0.64 
Big Blind: raises $1.13 to $1.77 and is all-in
UTG: calls $0.96 and is all-in
*** RIVER *** [Js 3h 2h Jc] [7c]
*** SHOW DOWN ***
Big Blind: shows [Qc Jd] (three of a kind, Jacks)
UTG: shows [Jh Kh] (three of a kind, Jacks)
Uncalled bet ($0.17) returned to Big Blind
UTG collected $4.26 from pot
Table deposit $5 
Table deposit $2.50 
*** SUMMARY ***
Total pot $4.48 | Rake $0.22
Board [Js 3h 2h Jc 7c]
Seat 1: Big Blind (big blind) showed [Qc Jd] and lost with three of a kind, Jacks
Seat 2: UTG showed [Jh Kh] and won ($4.26) with three of a kind, Jacks
Seat 3: Hero showed
Seat 4: UTGplus2 showed
Seat 5: Dealer (button) showed
Seat 6: Small Blind (small blind) showed



PokerStars Zoom Hand #3434288260: Hold'em No Limit ($0.02/$0.05) - 2017/03/08 21:20:32
Table '#952' 6-max Seat #5 is the button
Seat 1: Hero ($6.46 in chips)
Seat 2: UTG ($1.37 in chips)
Seat 3: UTGplus1 ($4.50 in chips)
Seat 4: UTGplus2 ($5.33 in chips)
Seat 5: Dealer ($11.19 in chips)
Seat 6: Small Blind ($8.74 in chips)
Small Blind: posts small blind $0.02
Hero: posts big blind $0.05
*** HOLE CARDS ***
Dealt to Hero [Tc 4c]
UTG: calls $0.05 
UTGplus1: folds
UTGplus2: folds
Dealer: folds
Small Blind: calls $0.03 
Hero: checks
*** FLOP *** [9d 6c 9c]
Small Blind: checks
Hero: checks
UTG: checks
*** TURN *** [9d 6c 9c] [Jh]
Small Blind: checks
Hero: checks
UTG: bets $0.15 
Small Blind: folds
Hero: folds
Uncalled bet ($0.15) returned to UTG
UTG: doesn't show hand
UTG collected $0.15 from pot
*** SUMMARY ***
Total pot $0.15 | Rake $0.00
Board [9d 6c 9c Jh]
Seat 1: Hero (big blind) showed
Seat 2: UTG won ($0.15)
Seat 3: UTGplus1 showed
Seat 4: UTGplus2 showed
Seat 5: Dealer (button) showed
Seat 6: Small Blind (small blind) showed



PokerStars Zoom Hand #3434288322: Hold'em No Limit ($0.02/$0.05) - 2017/03/08 21:20:39
Table '#952' 6-max Seat #2 is the button
Seat 1: UTGplus2 ($4.42 in chips)
Seat 2: Dealer ($5.43 in chips)
Seat 3: Hero ($6.41 in chips)
Seat 4: Big Blind ($2.50 in chips)
Seat 5: UTG ($2.09 in chips)
Seat 6: UTGplus1 ($4.31 in chips)
Hero: posts small blind $0.02
Big Blind: posts big blind $0.05
*** HOLE CARDS ***
Dealt to Hero [Qc 4d]
UTG: raises $0.19 to $0.19
UTGplus1: folds
UTGplus2: folds
Dealer: folds 
Hero: folds
Big Blind: calls $0.14 
*** FLOP *** [Kd Qs 2d]
Big Blind: checks
UTG: checks
*** TURN *** [Kd Qs 2d] [8c]
Dealer: Seat re-join
Big Blind: bets $0.30 
UTG: calls $0.30 
*** RIVER *** [Kd Qs 2d 8c] [Jh]
Big Blind: bets $0.75 
UTG: raises $1.50 to $1.50
Big Blind: folds
Uncalled bet ($0.75) returned to UTG
UTG: doesn't show hand
UTG collected $2.38 from pot
*** SUMMARY ***
Total pot $2.5 | Rake $0.12
Board [Kd Qs 2d 8c Jh]
Seat 1: UTGplus2 showed
Seat 2: Dealer (button) showed
Seat 3: Hero (small blind) showed
Seat 4: Big Blind (big blind) showed
Seat 5: UTG won ($2.38)
Seat 6: UTGplus1 showed



PokerStars Zoom Hand #3434288421: Hold'em No Limit ($0.02/$0.05) - 2017/03/08 21:20:51
Table '#952' 6-max Seat #1 is the button
Seat 1: Dealer ($2.66 in chips)
Seat 2: Hero ($6.39 in chips)
Seat 3: Big Blind ($2.84 in chips)
Seat 4: UTG ($4.88 in chips)
Seat 5: UTGplus1 ($6.41 in chips)
Seat 6: UTGplus2 ($4.65 in chips)
Hero: posts small blind $0.02
Big Blind: posts big blind $0.05
*** HOLE CARDS ***
Dealt to Hero [6s 2c]
UTG: folds
UTGplus1: folds
UTGplus2: calls $0.05 
Dealer: folds
Hero: folds
Big Blind: checks
*** FLOP *** [3c Tc 2s]
Big Blind: checks
UTGplus2: checks
*** TURN *** [3c Tc 2s] [5h]
Big Blind: checks
UTGplus2: checks
*** RIVER *** [3c Tc 2s 5h] [4h]
Big Blind: checks
UTGplus2: checks
*** SHOW DOWN ***
Big Blind: shows [Ts 4s] (two pair, Tens and Fives)
UTGplus2: shows [Qc As] (a straight, Ace to Five)
UTGplus2 collected $0.12 from pot
*** SUMMARY ***
Total pot $0.12 | Rake $0.00
Board [3c Tc 2s 5h 4h]
Seat 1: Dealer (button) showed
Seat 2: Hero (small blind) showed
Seat 3: Big Blind (big blind) showed [Ts 4s] and lost with two pair, Tens and Fives
Seat 4: UTG showed
Seat 5: UTGplus1 showed
Seat 6: UTGplus2 showed [Qc As] and won ($0.12) with a straight, Ace to Five



PokerStars Zoom Hand #3434288456: Hold'em No Limit ($0.02/$0.05) - 2017/03/08 21:20:56
Table '#952' 6-max Seat #6 is the button
Seat 1: Small Blind ($4.94 in chips)
Seat 2: Big Blind ($4.62 in chips)
Seat 3: UTG ($9.56 in chips)
Seat 4: UTGplus1 ($5.39 in chips)
Seat 5: Hero ($6.37 in chips)
Seat 6: Dealer ($5.33 in chips)
Small Blind: posts small blind $0.02
Big Blind: posts big blind $0.05
*** HOLE CARDS ***
Dealt to Hero [9d Qc]
UTG: raises $0.17 to $0.17
UTGplus1: folds
Hero: folds
Dealer: folds
Small Blind: folds
Big Blind: folds
Uncalled bet ($0.12) returned to UTG
UTG: doesn't show hand
UTG collected $0.12 from pot
*** SUMMARY ***
Total pot $0.12 | Rake $0.00
Seat 1: Small Blind (small blind) showed
Seat 2: Big Blind (big blind) showed
Seat 3: UTG won ($0.12)
Seat 4: UTGplus1 showed
Seat 5: Hero showed
Seat 6: Dealer (button) showed



PokerStars Zoom Hand #3434288541: Hold'em No Limit ($0.02/$0.05) - 2017/03/08 21:21:08
Table '#952' 6-max Seat #1 is the button
Seat 1: Hero ($6.37 in chips)
Seat 2: Small Blind ($11.75 in chips)
Seat 3: Big Blind ($2.50 in chips)
Seat 4: UTG ($6.41 in chips)
Seat 5: UTGplus1 ($2.66 in chips)
Seat 6: UTGplus2 ($4.38 in chips)
Small Blind: posts small blind $0.02
Big Blind: posts big blind $0.05
*** HOLE CARDS ***
Dealt to Hero [Tc 3s]
UTG: raises $0.15 to $0.15
UTGplus1: folds
UTGplus2: folds
Hero: folds
Small Blind: calls $0.13 
Big Blind: folds
*** FLOP *** [6s 2h 2s]
Small Blind: bets $0.05 
UTG: raises $0.25 to $0.25
Small Blind: raises $0.50 to $0.55
UTG: calls $0.30 
*** TURN *** [6s 2h 2s] [Ks]
Small Blind: bets $0.55 
UTG: calls $0.55 
*** RIVER *** [6s 2h 2s Ks] [Kh]
Small Blind: checks
UTG: bets $1.67 
Small Blind: folds
Uncalled bet ($1.67) returned to UTG
UTG: doesn't show hand
UTG collected $2.43 from pot
*** SUMMARY ***
Total pot $2.55 | Rake $0.12
Board [6s 2h 2s Ks Kh]
Seat 1: Hero (button) showed
Seat 2: Small Blind (small blind) showed
Seat 3: Big Blind (big blind) showed
Seat 4: UTG won ($2.43)
Seat 5: UTGplus1 showed
Seat 6: UTGplus2 showed



PokerStars Zoom Hand #3434288578: Hold'em No Limit ($0.02/$0.05) - 2017/03/08 21:21:13
Table '#952' 6-max Seat #2 is the button
Seat 1: Hero ($6.37 in chips)
Seat 2: Dealer ($11.94 in chips)
Seat 3: Small Blind ($5.39 in chips)
Seat 4: Big Blind ($8.87 in chips)
Seat 5: UTG ($5.43 in chips)
Seat 6: UTGplus1 ($3.63 in chips)
Small Blind: posts small blind $0.02
Big Blind: posts big blind $0.05
*** HOLE CARDS ***
Dealt to Hero [6c Th]
UTG: folds 
UTGplus1: raises $0.15 to $0.15
Hero: folds
Dealer: calls $0.15 
Small Blind: folds
Big Blind: folds
*** FLOP *** [Td Ad 3d]
UTGplus1: bets $0.18 
Dealer: calls $0.18 
*** TURN *** [Td Ad 3d] [7d]
UTGplus1: bets $0.36 
UTG: Seat re-join
Dealer: folds
Uncalled bet ($0.36) returned to UTGplus1
UTGplus1: doesn't show hand
UTGplus1 collected $0.7 from pot
*** SUMMARY ***
Total pot $0.73 | Rake $0.03
Board [Td Ad 3d 7d]
Seat 1: Hero showed
Seat 2: Dealer (button) showed
Seat 3: Small Blind (small blind) showed
Seat 4: Big Blind (big blind) showed
Seat 5: UTG showed
Seat 6: UTGplus1 won ($0.7)



PokerStars Zoom Hand #3434288613: Hold'em No Limit ($0.02/$0.05) - 2017/03/08 21:21:17
Table '#952' 6-max Seat #4 is the button
Seat 1: UTG ($11.65 in chips)
Seat 2: UTGplus1 ($3.79 in chips)
Seat 3: UTGplus2 ($10.91 in chips)
Seat 4: Dealer ($2.61 in chips)
Seat 5: Small Blind ($2.45 in chips)
Seat 6: Hero ($6.37 in chips)
Small Blind: posts small blind $0.02
Hero: posts big blind $0.05
*** HOLE CARDS ***
Dealt to Hero [5c 5h]
UTG: folds
UTGplus1: folds
UTGplus2: raises $0.15 to $0.15
Dealer: folds
Small Blind: folds
Hero: calls $0.10 
*** FLOP *** [6d 4c 3h]
Hero: checks
UTGplus2: bets $0.32 
Hero: calls $0.32 
*** TURN *** [6d 4c 3h] [Qh]
Hero: checks
UTGplus2: checks
*** RIVER *** [6d 4c 3h Qh] [4s]
Hero: checks
UTGplus2: bets $0.96 
Hero: folds
Uncalled bet ($0.96) returned to UTGplus2
UTGplus2: doesn't show hand
UTGplus2 collected $0.92 from pot
*** SUMMARY ***
Total pot $0.96 | Rake $0.04
Board [6d 4c 3h Qh 4s]
Seat 1: UTG showed
Seat 2: UTGplus1 showed
Seat 3: UTGplus2 won ($0.92)
Seat 4: Dealer (button) showed
Seat 5: Small Blind (small blind) showed
Seat 6: Hero (big blind) showed



PokerStars Zoom Hand #3434289173: Hold'em No Limit ($0.02/$0.05) - 2017/03/08 21:22:25
Table '#952' 6-max Seat #5 is the button
Seat 1: Big Blind ($11.61 in chips)
Seat 2: UTG ($2.72 in chips)
Seat 3: UTGplus1 ($5.57 in chips)
Seat 4: UTGplus2 ($3.98 in chips)
Seat 5: Hero ($5.90 in chips)
Seat 6: Small Blind ($4.46 in chips)
Small Blind: posts small blind $0.02
Big Blind: posts big blind $0.05
*** HOLE CARDS ***
Dealt to Hero [5s Qh]
UTG: folds
UTGplus1: folds
UTGplus2: raises $0.15 to $0.15
Hero: folds
Small Blind: calls $0.13 
Big Blind: calls $0.10 
*** FLOP *** [3s 7c 2h]
Small Blind: checks
Big Blind: checks
UTGplus2: checks
*** TURN *** [3s 7c 2h] [5c]
Small Blind: bets $0.05 
Big Blind: calls $0.05 
UTGplus2: folds
*** RIVER *** [3s 7c 2h 5c] [Kd]
Small Blind: checks
Big Blind: checks
*** SHOW DOWN ***
Small Blind: shows [As Tc] (high card Ace)
Big Blind: shows [4h 3d] (a pair of Threes)
Big Blind collected $0.53 from pot
*** SUMMARY ***
Total pot $0.55 | Rake $0.02
Board [3s 7c 2h 5c Kd]
Seat 1: Big Blind (big blind) showed [4h 3d] and won ($0.53) with a pair of Threes
Seat 2: UTG showed
Seat 3: UTGplus1 showed
Seat 4: UTGplus2 showed
Seat 5: Hero (button) showed
Seat 6: Small Blind (small blind) showed [As Tc-As Kd Tc 7c 5c] and lost with high card Ace



PokerStars Zoom Hand #3434289201: Hold'em No Limit ($0.02/$0.05) - 2017/03/08 21:22:29
Table '#952' 6-max Seat #5 is the button
Seat 1: Big Blind ($11.65 in chips)
Seat 2: UTG ($2.02 in chips)
Seat 3: UTGplus1 ($1.67 in chips)
Seat 4: Hero ($5.90 in chips)
Seat 5: Dealer ($2.72 in chips)
Seat 6: Small Blind ($11.11 in chips)
Small Blind: posts small blind $0.02
Big Blind: posts big blind $0.05
*** HOLE CARDS ***
Dealt to Hero [4s 9s]
UTG: calls $0.05 
UTGplus1: calls $0.05 
Hero: folds
Dealer: folds
Small Blind: folds
Big Blind: checks
*** FLOP *** [Td Jd 5c]
Big Blind: checks
UTG: checks
UTGplus1: checks
*** TURN *** [Td Jd 5c] [Qc]
Big Blind: checks
UTG: checks
UTGplus1: checks
*** RIVER *** [Td Jd 5c Qc] [4h]
Big Blind: checks
UTG: bets $0.05 
UTGplus1: folds
Big Blind: folds
Uncalled bet ($0.05) returned to UTG
UTG: doesn't show hand
UTG collected $0.17 from pot
*** SUMMARY ***
Total pot $0.17 | Rake $0.00
Board [Td Jd 5c Qc 4h]
Seat 1: Big Blind (big blind) showed
Seat 2: UTG won ($0.17)
Seat 3: UTGplus1 showed
Seat 4: Hero showed
Seat 5: Dealer (button) showed
Seat 6: Small Blind (small blind) showed



PokerStars Zoom Hand #3434289249: Hold'em No Limit ($0.02/$0.05) - 2017/03/08 21:22:35
Table '#952' 6-max Seat #5 is the button
Seat 1: Big Blind ($4 in chips)
Seat 2: UTG ($9.33 in chips)
Seat 3: UTGplus1 ($11.34 in chips)
Seat 4: UTGplus2 ($5.38 in chips)
Seat 5: Hero ($5.90 in chips)
Seat 6: Small Blind ($7.59 in chips)
Small Blind: posts small blind $0.02
Big Blind: posts big blind $0.05
*** HOLE CARDS ***
Dealt to Hero [Kd 9h]
UTG: folds
UTGplus1: folds
UTGplus2: folds
Hero: raises $0.17 to $0.17
Small Blind: calls $0.15 
Big Blind: folds
*** FLOP *** [3c 8h 7h]
Small Blind: checks
Hero: checks
*** TURN *** [3c 8h 7h] [Ad]
Small Blind: checks
Hero: checks
*** RIVER *** [3c 8h 7h Ad] [Kc]
Small Blind: checks
Hero: checks
*** SHOW DOWN ***
Small Blind: shows [5c 7c] (a pair of Sevens)
Hero: shows [Kd 9h] (a pair of Kings)
Hero collected $0.38 from pot
Table leave user
Seat re-join
*** SUMMARY ***
Total pot $0.39 | Rake $0.01
Board [3c 8h 7h Ad Kc]
Seat 1: Big Blind (big blind) showed
Seat 2: UTG showed
Seat 3: UTGplus1 showed
Seat 4: UTGplus2 showed
Seat 5: Hero (button) showed [Kd 9h] and won ($0.38) with a pair of Kings
Seat 6: Small Blind (small blind) showed [5c 7c] and lost with a pair of Sevens



PokerStars Zoom Hand #3434289635: Hold'em No Limit ($0.02/$0.05) - 2017/03/08 21:23:26
Table '#952' 6-max Seat #6 is the button
Seat 1: Small Blind ($4.95 in chips)
Seat 2: Big Blind ($4.52 in chips)
Seat 3: UTG ($5 in chips)
Seat 4: UTGplus1 ($7.34 in chips)
Seat 5: Hero ($6.11 in chips)
Seat 6: Dealer ($7.42 in chips)
Small Blind: posts small blind $0.02
Big Blind: posts big blind $0.05
*** HOLE CARDS ***
Dealt to Hero [2c 6c]
UTG: folds
UTGplus1: folds
Hero: folds
Dealer: folds
Small Blind: folds
Big Blind: doesn't show hand
Big Blind collected $0.07 from pot
*** SUMMARY ***
Total pot $0.07 | Rake $0.00
Seat 1: Small Blind (small blind) showed
Seat 2: Big Blind (big blind) won ($0.07)
Seat 3: UTG showed
Seat 4: UTGplus1 showed
Seat 5: Hero showed
Seat 6: Dealer (button) showed



PokerStars Zoom Hand #3434289663: Hold'em No Limit ($0.02/$0.05) - 2017/03/08 21:23:31
Table '#952' 6-max Seat #3 is the button
Seat 1: UTGplus1 ($8.05 in chips)
Seat 2: UTGplus2 ($22.76 in chips)
Seat 3: Dealer ($4.87 in chips)
Seat 4: Small Blind ($4.61 in chips)
Seat 5: Big Blind ($7.34 in chips)
Seat 6: Hero ($6.11 in chips)
Small Blind: posts small blind $0.02
Big Blind: posts big blind $0.05
*** HOLE CARDS ***
Dealt to Hero [Jh 5h]
Hero: folds
UTGplus1: raises $0.17 to $0.17
UTGplus2: calls $0.17 
Dealer: folds
Small Blind: raises $0.27 to $0.29
Big Blind: folds
UTGplus1: calls $0.12 
UTGplus2: calls $0.12 
*** FLOP *** [9h 2h Jd]
Small Blind: bets $0.92 
UTGplus1: folds
UTGplus2: folds
Uncalled bet ($0.92) returned to Small Blind
Small Blind: doesn't show hand
Small Blind collected $0.88 from pot
*** SUMMARY ***
Total pot $0.92 | Rake $0.04
Board [9h 2h Jd]
Seat 1: UTGplus1 showed
Seat 2: UTGplus2 showed
Seat 3: Dealer (button) showed
Seat 4: Small Blind (small blind) won ($0.88)
Seat 5: Big Blind (big blind) showed
Seat 6: Hero showed



PokerStars Zoom Hand #3434289695: Hold'em No Limit ($0.02/$0.05) - 2017/03/08 21:23:35
Table '#952' 6-max Seat #6 is the button
Seat 1: Small Blind ($4.87 in chips)
Seat 2: Big Blind ($2.50 in chips)
Seat 3: UTG ($7.61 in chips)
Seat 4: Hero ($6.11 in chips)
Seat 5: UTGplus2 ($2.55 in chips)
Seat 6: Dealer ($3.67 in chips)
Small Blind: posts small blind $0.02
Big Blind: posts big blind $0.05
*** HOLE CARDS ***
Dealt to Hero [Jd 6s]
UTG: raises $0.15 to $0.15
Hero: folds
UTGplus2: folds
Dealer: folds
Small Blind: folds
Big Blind: folds
Uncalled bet ($0.10) returned to UTG
UTG: doesn't show hand
UTG collected $0.12 from pot
*** SUMMARY ***
Total pot $0.12 | Rake $0.00
Seat 1: Small Blind (small blind) showed
Seat 2: Big Blind (big blind) showed
Seat 3: UTG won ($0.12)
Seat 4: Hero showed
Seat 5: UTGplus2 showed
Seat 6: Dealer (button) showed



PokerStars Zoom Hand #3434289727: Hold'em No Limit ($0.02/$0.05) - 2017/03/08 21:23:40
Table '#952' 6-max Seat #3 is the button
Seat 1: UTGplus1 ($3.45 in chips)
Seat 2: UTGplus2 ($3.24 in chips)
Seat 3: Dealer ($4.71 in chips)
Seat 4: Small Blind ($2.50 in chips)
Seat 5: Hero ($6.11 in chips)
Seat 6: UTG ($5.23 in chips)
Small Blind: posts small blind $0.02
Hero: posts big blind $0.05
*** HOLE CARDS ***
Dealt to Hero [5c 5s]
UTG: folds
UTGplus1: folds
UTGplus2: folds
Dealer: folds
Small Blind: folds
Hero: doesn't show hand
Hero collected $0.07 from pot
*** SUMMARY ***
Total pot $0.07 | Rake $0.00
Seat 1: UTGplus1 showed
Seat 2: UTGplus2 showed
Seat 3: Dealer (button) showed
Seat 4: Small Blind (small blind) showed
Seat 5: Hero (big blind) won ($0.07)
Seat 6: UTG showed



PokerStars Zoom Hand #3434289848: Hold'em No Limit ($0.02/$0.05) - 2017/03/08 21:23:56
Table '#952' 6-max Seat #1 is the button
Seat 1: Dealer ($3.28 in chips)
Seat 2: Small Blind ($4.76 in chips)
Seat 3: Big Blind ($5.09 in chips)
Seat 4: UTG ($0.40 in chips)
Seat 5: Hero ($6.13 in chips)
Seat 6: UTGplus2 ($4.57 in chips)
Small Blind: posts small blind $0.02
Big Blind: posts big blind $0.05
*** HOLE CARDS ***
Dealt to Hero [6d 9c]
UTG: raises $0.10 to $0.10
Hero: folds
UTGplus2: folds
Dealer: folds
Small Blind: folds
Big Blind: calls $0.05 
*** FLOP *** [Tc 5d Ks]
Big Blind: checks
UTG: checks
*** TURN *** [Tc 5d Ks] [5c]
Big Blind: checks
UTG: bets $0.30 and is all-in
Big Blind: folds
Uncalled bet ($0.30) returned to UTG
UTG: doesn't show hand
UTG collected $0.21 from pot
*** SUMMARY ***
Total pot $0.22 | Rake $0.01
Board [Tc 5d Ks 5c]
Seat 1: Dealer (button) showed
Seat 2: Small Blind (small blind) showed
Seat 3: Big Blind (big blind) showed
Seat 4: UTG won ($0.21)
Seat 5: Hero showed
Seat 6: UTGplus2 showed



PokerStars Zoom Hand #3434289893: Hold'em No Limit ($0.02/$0.05) - 2017/03/08 21:24:01
Table '#952' 6-max Seat #5 is the button
Seat 1: Big Blind ($3.41 in chips)
Seat 2: UTG ($7.23 in chips)
Seat 3: UTGplus1 ($8.26 in chips)
Seat 4: UTGplus2 ($8.50 in chips)
Seat 5: Dealer ($3.45 in chips)
Seat 6: Hero ($6.13 in chips)
Hero: posts small blind $0.02
Big Blind: posts big blind $0.05
*** HOLE CARDS ***
Dealt to Hero [8h Tc]
UTG: raises $0.17 to $0.17
UTGplus1: folds
UTGplus2: folds
Dealer: calls $0.17 
Hero: folds
Big Blind: folds
*** FLOP *** [Td Kc 4s]
UTG: checks
Dealer: bets $0.20 
UTG: calls $0.20 
*** TURN *** [Td Kc 4s] [6d]
UTG: checks
Dealer: bets $0.40 
UTG: calls $0.40 
*** RIVER *** [Td Kc 4s 6d] [7c]
UTG: bets $1.61 
Dealer: folds
Uncalled bet ($1.61) returned to UTG
UTG: doesn't show hand
UTG collected $1.53 from pot
*** SUMMARY ***
Total pot $1.61 | Rake $0.08
Board [Td Kc 4s 6d 7c]
Seat 1: Big Blind (big blind) showed
Seat 2: UTG won ($1.53)
Seat 3: UTGplus1 showed
Seat 4: UTGplus2 showed
Seat 5: Dealer (button) showed
Seat 6: Hero (small blind) showed



PokerStars Zoom Hand #3434289934: Hold'em No Limit ($0.02/$0.05) - 2017/03/08 21:24:06
Table '#952' 6-max Seat #3 is the button
Seat 1: Hero ($6.11 in chips)
Seat 2: UTGplus2 ($4.85 in chips)
Seat 3: Dealer ($3.28 in chips)
Seat 4: Small Blind ($2.53 in chips)
Seat 5: Big Blind ($11.40 in chips)
Seat 6: UTG ($5.04 in chips)
Small Blind: posts small blind $0.02
Big Blind: posts big blind $0.05
*** HOLE CARDS ***
Dealt to Hero [9h 9d]
UTG: folds
Hero: raises $0.17 to $0.17
UTGplus2: folds
Dealer: folds
Small Blind: folds
Big Blind: folds
Uncalled bet ($0.12) returned to Hero
Hero: doesn't show hand
Hero collected $0.12 from pot
*** SUMMARY ***
Total pot $0.12 | Rake $0.00
Seat 1: Hero won ($0.12)
Seat 2: UTGplus2 showed
Seat 3: Dealer (button) showed
Seat 4: Small Blind (small blind) showed
Seat 5: Big Blind (big blind) showed
Seat 6: UTG showed



PokerStars Zoom Hand #3434290124: Hold'em No Limit ($0.02/$0.05) - 2017/03/08 21:24:30
Table '#952' 6-max Seat #4 is the button
Seat 1: UTG ($4.19 in chips)
Seat 2: UTGplus1 ($2.51 in chips)
Seat 3: UTGplus2 ($6.18 in chips)
Seat 4: Hero ($6.18 in chips)
Seat 5: Small Blind ($4.93 in chips)
Seat 6: Big Blind ($5 in chips)
Small Blind: posts small blind $0.02
Big Blind: posts big blind $0.05
*** HOLE CARDS ***
Dealt to Hero [Kd 4d]
UTG: folds
UTGplus1: folds
UTGplus2: folds
Hero: folds
Small Blind: folds
Big Blind: doesn't show hand
Big Blind collected $0.07 from pot
*** SUMMARY ***
Total pot $0.07 | Rake $0.00
Seat 1: UTG showed
Seat 2: UTGplus1 showed
Seat 3: UTGplus2 showed
Seat 4: Hero (button) showed
Seat 5: Small Blind (small blind) showed
Seat 6: Big Blind (big blind) won ($0.07)



PokerStars Zoom Hand #3434290177: Hold'em No Limit ($0.02/$0.05) - 2017/03/08 21:24:37
Table '#952' 6-max Seat #4 is the button
Seat 1: Hero ($6.18 in chips)
Seat 2: UTGplus1 ($5.48 in chips)
Seat 3: UTGplus2 ($4.55 in chips)
Seat 4: Dealer ($2.65 in chips)
Seat 5: Small Blind ($1.11 in chips)
Seat 6: Big Blind ($2.51 in chips)
Small Blind: posts small blind $0.02
Big Blind: posts big blind $0.05
*** HOLE CARDS ***
Dealt to Hero [Qh 5c]
Hero: folds
UTGplus1: folds
UTGplus2: folds
Dealer: folds 
Small Blind: folds
*** SHOW DOWN ***
Big Blind: shows [Ac Kh] (high card Ace)
Big Blind collected $0.07 from pot
*** SUMMARY ***
Total pot $0.07 | Rake $0.00
Seat 1: Hero showed
Seat 2: UTGplus1 showed
Seat 3: UTGplus2 showed
Seat 4: Dealer (button) showed
Seat 5: Small Blind (small blind) showed
Seat 6: Big Blind (big blind) collected $0.02



PokerStars Zoom Hand #3434290231: Hold'em No Limit ($0.02/$0.05) - 2017/03/08 21:24:43
Table '#952' 6-max Seat #3 is the button
Seat 1: UTGplus1 ($4.89 in chips)
Seat 2: Hero ($6.18 in chips)
Seat 3: Dealer ($4.98 in chips)
Seat 4: Small Blind ($13.57 in chips)
Seat 5: Big Blind ($5.48 in chips)
Seat 6: UTG ($4.95 in chips)
Small Blind: posts small blind $0.02
Big Blind: posts big blind $0.05
*** HOLE CARDS ***
Dealt to Hero [5c Td]
UTG: folds
UTGplus1: raises $0.15 to $0.15
Hero: folds
Dealer: raises $0.25 to $0.25
Small Blind: folds
Big Blind: folds
UTGplus1: folds 
Uncalled bet ($0.10) returned to Dealer
Dealer: doesn't show hand
Dealer collected $0.37 from pot
*** SUMMARY ***
Total pot $0.37 | Rake $0.00
Seat 1: UTGplus1 showed
Seat 2: Hero showed
Seat 3: Dealer (button) won ($0.37)
Seat 4: Small Blind (small blind) showed
Seat 5: Big Blind (big blind) showed
Seat 6: UTG showed



PokerStars Zoom Hand #3434290292: Hold'em No Limit ($0.02/$0.05) - 2017/03/08 21:24:51
Table '#952' 6-max Seat #5 is the button
Seat 1: Hero ($6.18 in chips)
Seat 2: UTG ($3.51 in chips)
Seat 3: UTGplus1 ($4.97 in chips)
Seat 4: UTGplus2 ($8.73 in chips)
Seat 5: Dealer ($3.21 in chips)
Seat 6: Small Blind ($5.43 in chips)
Small Blind: posts small blind $0.02
Hero: posts big blind $0.05
*** HOLE CARDS ***
Dealt to Hero [Th 5h]
UTG: folds
UTGplus1: folds
UTGplus2: folds
Dealer: folds
Small Blind: raises $0.13 to $0.15
Hero: calls $0.10 
*** FLOP *** [5s 5d Td]
Small Blind: checks
Hero: checks
*** TURN *** [5s 5d Td] [Jd]
Small Blind: checks
Hero: bets $0.15 
Small Blind: folds
Uncalled bet ($0.15) returned to Hero
Hero: doesn't show hand
Hero collected $0.29 from pot
*** SUMMARY ***
Total pot $0.3 | Rake $0.01
Board [5s 5d Td Jd]
Seat 1: Hero (big blind) won ($0.29)
Seat 2: UTG showed
Seat 3: UTGplus1 showed
Seat 4: UTGplus2 showed
Seat 5: Dealer (button) showed
Seat 6: Small Blind (small blind) showed



PokerStars Zoom Hand #3434290775: Hold'em No Limit ($0.02/$0.05) - 2017/03/08 21:25:52
Table '#952' 6-max Seat #5 is the button
Seat 1: Big Blind ($5.04 in chips)
Seat 2: Hero ($6.32 in chips)
Seat 3: UTGplus1 ($2 in chips)
Seat 4: UTGplus2 ($3.04 in chips)
Seat 5: Dealer ($8.14 in chips)
Seat 6: Small Blind ($5.66 in chips)
Small Blind: posts small blind $0.02
Big Blind: posts big blind $0.05
*** HOLE CARDS ***
Dealt to Hero [4h 5d]
Hero: folds
UTGplus1: folds
UTGplus2: folds
Dealer: folds
Small Blind: raises $0.13 to $0.15
Big Blind: folds
Uncalled bet ($0.10) returned to Small Blind
Small Blind: doesn't show hand
Small Blind collected $0.1 from pot
Seat re-join
*** SUMMARY ***
Total pot $0.1 | Rake $0.00
Seat 1: Big Blind (big blind) showed
Seat 2: Hero showed
Seat 3: UTGplus1 showed
Seat 4: UTGplus2 showed
Seat 5: Dealer (button) showed
Seat 6: Small Blind (small blind) won ($0.1)



PokerStars Zoom Hand #3434290830: Hold'em No Limit ($0.02/$0.05) - 2017/03/08 21:25:59
Table '#952' 6-max Seat #2 is the button
Seat 1: UTGplus2 ($8.18 in chips)
Seat 2: Dealer ($5.17 in chips)
Seat 3: Small Blind ($4.45 in chips)
Seat 4: Big Blind ($11.66 in chips)
Seat 5: UTG ($10.78 in chips)
Seat 6: Hero ($6.32 in chips)
Small Blind: posts small blind $0.02
Big Blind: posts big blind $0.05
*** HOLE CARDS ***
Dealt to Hero [7c 5d]
UTG: raises $0.15 to $0.15
Hero: folds
UTGplus2: folds
Dealer: folds
Small Blind: folds
Big Blind: folds
Uncalled bet ($0.10) returned to UTG
UTG: doesn't show hand
UTG collected $0.12 from pot
*** SUMMARY ***
Total pot $0.12 | Rake $0.00
Seat 1: UTGplus2 showed
Seat 2: Dealer (button) showed
Seat 3: Small Blind (small blind) showed
Seat 4: Big Blind (big blind) showed
Seat 5: UTG won ($0.12)
Seat 6: Hero showed



PokerStars Zoom Hand #3434290882: Hold'em No Limit ($0.02/$0.05) - 2017/03/08 21:26:05
Table '#952' 6-max Seat #4 is the button
Seat 1: Hero ($6.32 in chips)
Seat 2: UTGplus1 ($4.48 in chips)
Seat 3: UTGplus2 ($4.70 in chips)
Seat 4: Dealer ($2.91 in chips)
Seat 5: Small Blind ($5.22 in chips)
Seat 6: Big Blind ($3.02 in chips)
Small Blind: posts small blind $0.02
Big Blind: posts big blind $0.05
*** HOLE CARDS ***
Dealt to Hero [3h Td]
Hero: folds
UTGplus1: folds
UTGplus2: raises $0.15 to $0.15
Dealer: folds
Small Blind: folds
Big Blind: folds
Uncalled bet ($0.10) returned to UTGplus2
UTGplus2: doesn't show hand
UTGplus2 collected $0.12 from pot
*** SUMMARY ***
Total pot $0.12 | Rake $0.00
Seat 1: Hero showed
Seat 2: UTGplus1 showed
Seat 3: UTGplus2 won ($0.12)
Seat 4: Dealer (button) showed
Seat 5: Small Blind (small blind) showed
Seat 6: Big Blind (big blind) showed



PokerStars Zoom Hand #3434290932: Hold'em No Limit ($0.02/$0.05) - 2017/03/08 21:26:11
Table '#952' 6-max Seat #1 is the button
Seat 1: Hero ($6.32 in chips)
Seat 2: Small Blind ($9.09 in chips)
Seat 3: Big Blind ($2 in chips)
Seat 4: UTG ($5.81 in chips)
Seat 5: UTGplus1 ($4.43 in chips)
Seat 6: UTGplus2 ($4.43 in chips)
Small Blind: posts small blind $0.02
Big Blind: posts big blind $0.05
*** HOLE CARDS ***
Dealt to Hero [2d Qh]
UTG: folds
UTGplus1: folds
UTGplus2: raises $0.15 to $0.15
Hero: folds
Small Blind: folds
Big Blind: folds
Uncalled bet ($0.10) returned to UTGplus2
UTGplus2: doesn't show hand
UTGplus2 collected $0.12 from pot
Table deposit $5 
*** SUMMARY ***
Total pot $0.12 | Rake $0.00
Seat 1: Hero (button) showed
Seat 2: Small Blind (small blind) showed
Seat 3: Big Blind (big blind) showed
Seat 4: UTG showed
Seat 5: UTGplus1 showed
Seat 6: UTGplus2 won ($0.12)



PokerStars Zoom Hand #3434290973: Hold'em No Limit ($0.02/$0.05) - 2017/03/08 21:26:17
Table '#952' 6-max Seat #1 is the button
Seat 1: Dealer ($12.21 in chips)
Seat 2: Small Blind ($5 in chips)
Seat 3: Hero ($6.32 in chips)
Seat 4: UTG ($5.81 in chips)
Seat 5: UTGplus1 ($5.17 in chips)
Seat 6: UTGplus2 ($4.13 in chips)
Small Blind: posts small blind $0.02
Hero: posts big blind $0.05
*** HOLE CARDS ***
Dealt to Hero [7c 8d]
UTG: folds
UTGplus1: folds
UTGplus2: folds
Dealer: folds
Small Blind: folds
Hero: doesn't show hand
Hero collected $0.07 from pot
*** SUMMARY ***
Total pot $0.07 | Rake $0.00
Seat 1: Dealer (button) showed
Seat 2: Small Blind (small blind) showed
Seat 3: Hero (big blind) won ($0.07)
Seat 4: UTG showed
Seat 5: UTGplus1 showed
Seat 6: UTGplus2 showed



PokerStars Zoom Hand #3434291088: Hold'em No Limit ($0.02/$0.05) - 2017/03/08 21:26:32
Table '#952' 6-max Seat #4 is the button
Seat 1: UTG ($5.20 in chips)
Seat 2: Hero ($6.34 in chips)
Seat 3: UTGplus2 ($7.65 in chips)
Seat 4: Dealer ($11.18 in chips)
Seat 5: Small Blind ($7.85 in chips)
Seat 6: Big Blind ($4.98 in chips)
Small Blind: posts small blind $0.02
Big Blind: posts big blind $0.05
*** HOLE CARDS ***
Dealt to Hero [9c 2h]
UTG: folds
Hero: folds
UTGplus2: folds
Dealer: raises $0.15 to $0.15
Small Blind: raises $0.53 to $0.55
Big Blind: folds
Dealer: folds
Uncalled bet ($0.40) returned to Small Blind
Small Blind: doesn't show hand
Small Blind collected $0.35 from pot
*** SUMMARY ***
Total pot $0.35 | Rake $0.00
Seat 1: UTG showed
Seat 2: Hero showed
Seat 3: UTGplus2 showed
Seat 4: Dealer (button) showed
Seat 5: Small Blind (small blind) won ($0.35)
Seat 6: Big Blind (big blind) showed



PokerStars Zoom Hand #3434291150: Hold'em No Limit ($0.02/$0.05) - 2017/03/08 21:26:38
Table '#952' 6-max Seat #5 is the button
Seat 1: Big Blind ($2.95 in chips)
Seat 2: Hero ($6.34 in chips)
Seat 3: UTGplus1 ($2.88 in chips)
Seat 4: UTGplus2 ($7.30 in chips)
Seat 5: Dealer ($8.61 in chips)
Seat 6: Small Blind ($4.49 in chips)
Small Blind: posts small blind $0.02
Big Blind: posts big blind $0.05
*** HOLE CARDS ***
Dealt to Hero [Qd 7c]
Hero: folds
UTGplus1: raises $0.10 to $0.10
UTGplus2: folds
Dealer: folds
Small Blind: folds
Big Blind: calls $0.05 
*** FLOP *** [Jh Qc 5s]
Big Blind: checks
UTGplus1: checks
*** TURN *** [Jh Qc 5s] [2c]
Big Blind: checks
UTGplus1: checks
*** RIVER *** [Jh Qc 5s 2c] [Ks]
Big Blind: checks
UTGplus1: checks
*** SHOW DOWN ***
Big Blind: shows [3s Ad] (high card Ace)
UTGplus1: shows [7h 3h] (High Card)
Big Blind collected $0.21 from pot
*** SUMMARY ***
Total pot $0.22 | Rake $0.01
Board [Jh Qc 5s 2c Ks]
Seat 1: Big Blind (big blind) showed [3s Ad] and won ($0.21) with high card Ace
Seat 2: Hero showed
Seat 3: UTGplus1 showed [7h 3h]
Seat 4: UTGplus2 showed
Seat 5: Dealer (button) showed
Seat 6: Small Blind (small blind) showed



PokerStars Zoom Hand #3434291202: Hold'em No Limit ($0.02/$0.05) - 2017/03/08 21:26:43
Table '#952' 6-max Seat #6 is the button
Seat 1: Hero ($6.34 in chips)
Seat 2: Big Blind ($3.64 in chips)
Seat 3: UTG ($3.29 in chips)
Seat 4: UTGplus1 ($13.01 in chips)
Seat 5: UTGplus2 ($11.45 in chips)
Seat 6: Dealer ($3.60 in chips)
Hero: posts small blind $0.02
Big Blind: posts big blind $0.05
*** HOLE CARDS ***
Dealt to Hero [6c 5c]
UTG: folds
UTGplus1: folds
UTGplus2: raises $0.27 to $0.27
Dealer: folds
Hero: folds
Big Blind: folds
Uncalled bet ($0.22) returned to UTGplus2
UTGplus2: doesn't show hand
UTGplus2 collected $0.12 from pot
*** SUMMARY ***
Total pot $0.12 | Rake $0.00
Seat 1: Hero (small blind) showed
Seat 2: Big Blind (big blind) showed
Seat 3: UTG showed
Seat 4: UTGplus1 showed
Seat 5: UTGplus2 won ($0.12)
Seat 6: Dealer (button) showed



PokerStars Zoom Hand #3434291301: Hold'em No Limit ($0.02/$0.05) - 2017/03/08 21:26:55
Table '#952' 6-max Seat #4 is the button
Seat 1: Hero ($6.32 in chips)
Seat 2: UTGplus1 ($4.36 in chips)
Seat 3: UTGplus2 ($11.01 in chips)
Seat 4: Dealer ($7.30 in chips)
Seat 5: Small Blind ($11.56 in chips)
Seat 6: Big Blind ($5.15 in chips)
Small Blind: posts small blind $0.02
Big Blind: posts big blind $0.05
*** HOLE CARDS ***
Dealt to Hero [6s 4c]
Hero: folds
UTGplus1: folds
UTGplus2: raises $0.15 to $0.15
Dealer: folds
Small Blind: folds
Big Blind: folds
Uncalled bet ($0.10) returned to UTGplus2
UTGplus2: doesn't show hand
UTGplus2 collected $0.12 from pot
*** SUMMARY ***
Total pot $0.12 | Rake $0.00
Seat 1: Hero showed
Seat 2: UTGplus1 showed
Seat 3: UTGplus2 won ($0.12)
Seat 4: Dealer (button) showed
Seat 5: Small Blind (small blind) showed
Seat 6: Big Blind (big blind) showed



PokerStars Zoom Hand #3434291344: Hold'em No Limit ($0.02/$0.05) - 2017/03/08 21:27:00
Table '#952' 6-max Seat #6 is the button
Seat 1: Small Blind ($8.16 in chips)
Seat 2: Big Blind ($5.38 in chips)
Seat 3: UTG ($5.10 in chips)
Seat 4: UTGplus1 ($2.59 in chips)
Seat 5: UTGplus2 ($5 in chips)
Seat 6: Hero ($6.32 in chips)
Small Blind: posts small blind $0.02
Big Blind: posts big blind $0.05
*** HOLE CARDS ***
Dealt to Hero [6d 6c]
UTG: folds
UTGplus1: folds
UTGplus2: raises $0.15 to $0.15
Hero: calls $0.15 
Small Blind: calls $0.13 
Big Blind: folds
*** FLOP *** [Ts 8d 2s]
Small Blind: checks
UTGplus2: bets $0.33 
Hero: calls $0.33 
Small Blind: folds
*** TURN *** [Ts 8d 2s] [Qh]
UTGplus2: bets $0.70 
Hero: folds
Uncalled bet ($0.70) returned to UTGplus2
UTGplus2: doesn't show hand
UTGplus2 collected $1.11 from pot
*** SUMMARY ***
Total pot $1.16 | Rake $0.05
Board [Ts 8d 2s Qh]
Seat 1: Small Blind (small blind) showed
Seat 2: Big Blind (big blind) showed
Seat 3: UTG showed
Seat 4: UTGplus1 showed
Seat 5: UTGplus2 won ($1.11)
Seat 6: Hero (button) showed



PokerStars Zoom Hand #3434291838: Hold'em No Limit ($0.02/$0.05) - 2017/03/08 21:28:00
Table '#952' 6-max Seat #5 is the button
Seat 1: Hero ($5.84 in chips)
Seat 2: UTG ($11.50 in chips)
Seat 3: UTGplus1 ($3.67 in chips)
Seat 4: UTGplus2 ($5.13 in chips)
Seat 5: Dealer ($5.71 in chips)
Seat 6: Small Blind ($5.12 in chips)
Small Blind: posts small blind $0.02
Hero: posts big blind $0.05
*** HOLE CARDS ***
Dealt to Hero [9d Jh]
UTG: folds
UTGplus1: folds
UTGplus2: folds
Dealer: folds
Small Blind: folds
Hero: doesn't show hand
Hero collected $0.07 from pot
*** SUMMARY ***
Total pot $0.07 | Rake $0.00
Seat 1: Hero (big blind) won ($0.07)
Seat 2: UTG showed
Seat 3: UTGplus1 showed
Seat 4: UTGplus2 showed
Seat 5: Dealer (button) showed
Seat 6: Small Blind (small blind) showed




